NUM_OF_BEDROOMS,NUM_OF_BATHROOMS,LIVING_AREA_sqft,LOT_AREA_sqft,FLOORS,WATER FRONT,VIEW_RATING,CONDITION_RATING,ABOVE_BASEMENT_sqft,BASEMENT_sqft,YEAR_BUILT,YEAR_RENOVATED,PRICE,CITY,ZIP,TOTAL_HOUSE_AREA_sqft
3.0,2.0,1340,7912,1.5,0.0,0.0,3.0,1340,0,1955,2005,313000.0,Shoreline,98133,1340
3.0,2.0,1930,11947,1.0,0.0,0.0,4.0,1930,0,1966,0,342000.0,Kent,98042,1930
3.0,2.0,2000,8030,1.0,0.0,0.0,4.0,1000,1000,1963,0,420000.0,Bellevue,98008,2000
4.0,2.0,1940,10500,1.0,0.0,0.0,4.0,1140,800,1976,1992,550000.0,Redmond,98052,1940
2.0,1.0,880,6380,1.0,0.0,0.0,3.0,880,0,1938,1994,490000.0,Seattle,98115,880
2.0,2.0,1350,2560,1.0,0.0,0.0,3.0,1350,0,1976,0,335000.0,Redmond,98052,1350
4.0,2.0,1520,6200,1.5,0.0,0.0,3.0,1520,0,1945,2010,640000.0,Seattle,98115,1520
3.0,2.0,1710,7320,1.0,0.0,0.0,3.0,1710,0,1948,1994,463000.0,LakeForestPark,98155,1710
3.0,2.0,2330,14892,1.0,0.0,0.0,3.0,1970,360,1980,0,588500.0,Sammamish,98074,2330
3.0,1.0,1090,6435,1.0,0.0,0.0,4.0,1090,0,1955,2009,365000.0,Seattle,98106,1090
3.0,2.0,1200,9720,1.0,0.0,0.0,4.0,1200,0,1965,0,242500.0,Kent,98042,1200
3.0,2.0,1570,6700,1.0,0.0,0.0,4.0,1570,0,1956,0,419000.0,Bellevue,98007,1570
4.0,3.0,3110,7231,2.0,0.0,0.0,3.0,3110,0,1997,0,367500.0,Auburn,98092,3110
3.0,2.0,1370,5858,1.0,0.0,0.0,3.0,1370,0,1987,2000,257950.0,DesMoines,98198,1370
3.0,2.0,1180,10277,1.0,0.0,0.0,3.0,1180,0,1983,2009,275000.0,NorthBend,98045,1180
3.0,2.0,2240,10578,2.0,0.0,0.0,5.0,1550,690,1923,0,750000.0,Seattle,98115,2240
4.0,1.0,1450,8800,1.0,0.0,0.0,4.0,1450,0,1954,1979,435000.0,Bellevue,98006,1450
3.0,2.0,1750,1572,2.5,0.0,0.0,3.0,1470,280,2005,0,626000.0,Seattle,98102,1750
4.0,2.0,2730,12261,2.0,0.0,0.0,3.0,2730,0,1991,0,612500.0,Bothell,98011,2730
4.0,2.0,1600,6380,1.0,0.0,0.0,3.0,1130,470,1959,1989,495000.0,Seattle,98125,1600
3.0,2.0,2090,10834,1.0,0.0,0.0,4.0,1360,730,1987,0,285000.0,FederalWay,98003,2090
3.0,2.0,2360,7291,1.0,0.0,0.0,4.0,1360,1000,1948,0,615000.0,Seattle,98136,2360
4.0,2.0,2200,11250,1.5,0.0,0.0,5.0,1300,900,1920,0,698000.0,Kirkland,98033,2200
3.0,2.0,2600,4750,1.0,0.0,0.0,4.0,1700,900,1951,1999,790000.0,Seattle,98117,2600
4.0,2.0,1560,8700,1.0,0.0,0.0,4.0,1560,0,1967,0,382500.0,Kirkland,98034,1560
4.0,2.0,1820,5000,1.5,0.0,1.0,3.0,1640,180,1945,2010,650000.0,Seattle,98115,1820
4.0,2.0,2820,8408,2.0,0.0,0.0,3.0,2820,0,2014,0,625000.0,Shoreline,98155,2820
2.0,1.0,800,4850,1.0,0.0,0.0,4.0,800,0,1944,0,440000.0,Seattle,98107,800
3.0,2.0,1960,13100,1.0,0.0,2.0,5.0,1650,310,1957,0,403000.0,NormandyPark,98166,1960
3.0,2.0,2390,6550,1.0,0.0,2.0,4.0,1440,950,1955,2009,750000.0,Seattle,98116,2390
3.0,2.0,1580,16215,1.0,0.0,0.0,4.0,1580,0,1978,2000,335000.0,FallCity,98024,1580
4.0,2.0,1480,8625,1.0,0.0,0.0,4.0,1480,0,1974,0,260000.0,Renton,98055,1480
2.0,1.0,850,6174,1.0,0.0,0.0,4.0,850,0,1950,1983,308500.0,Shoreline,98155,850
3.0,2.0,1770,2875,2.0,0.0,0.0,3.0,1770,0,1990,2009,439950.0,Seattle,98116,1770
2.0,1.0,1210,9400,1.0,0.0,0.0,2.0,1210,0,1949,0,235000.0,Seattle,98106,1210
3.0,1.0,1160,9180,1.0,0.0,0.0,3.0,1160,0,1968,1997,315000.0,Woodinville,98077,1160
3.0,2.0,1930,10460,2.0,0.0,0.0,3.0,1930,0,1996,0,407500.0,Renton,98059,1930
3.0,2.0,1270,1180,3.0,0.0,0.0,3.0,1270,0,2001,0,445700.0,Seattle,98107,1270
3.0,2.0,2710,4500,1.5,0.0,0.0,4.0,1880,830,1929,0,805000.0,Seattle,98115,2710
5.0,2.0,2210,9655,1.0,0.0,0.0,3.0,1460,750,1976,0,470000.0,Bothell,98011,2210
4.0,2.0,1920,10000,1.0,0.0,0.0,4.0,1070,850,1954,1979,430000.0,Bellevue,98006,1920
5.0,3.0,3660,11995,2.0,0.0,2.0,3.0,3660,0,2006,0,785000.0,Snoqualmie,98065,3660
3.0,3.0,1320,1327,2.0,0.0,0.0,3.0,1040,280,2008,0,385000.0,Seattle,98199,1320
2.0,2.0,1630,1368,2.0,0.0,0.0,3.0,1280,350,2009,0,295000.0,Seattle,98106,1630
3.0,2.0,2540,5050,2.0,0.0,0.0,3.0,2540,0,2006,0,300000.0,Kent,98042,2540
2.0,1.0,900,5000,1.0,0.0,0.0,3.0,900,0,1944,0,553000.0,Seattle,98117,900
3.0,2.0,1650,14054,1.0,0.0,0.0,4.0,1130,520,1986,0,379880.0,Issaquah,98027,1650
3.0,1.0,1010,9945,1.0,0.0,0.0,4.0,1010,0,1973,0,310000.0,Snoqualmie,98065,1010
3.0,2.0,2200,7350,1.0,0.0,0.0,5.0,1570,630,1988,0,365000.0,Renton,98058,2200
4.0,2.0,2530,9933,2.0,0.0,2.0,3.0,2010,520,1990,2009,331950.0,Auburn,98092,2530
3.0,2.0,2850,7130,2.0,0.0,0.0,3.0,1990,860,1980,0,783500.0,Seattle,98122,2850
3.0,2.0,1900,8744,2.0,0.0,0.0,3.0,1900,0,1987,2000,560000.0,Sammamish,98074,1900
2.0,3.0,1270,1175,2.0,0.0,0.0,3.0,1110,160,2000,0,531000.0,Seattle,98103,1270
4.0,3.0,2170,4000,2.0,0.0,0.0,4.0,1610,560,1982,2011,831000.0,Seattle,98112,2170
4.0,2.0,2730,10281,2.0,0.0,2.0,3.0,2730,0,1996,0,780000.0,Sammamish,98074,2730
4.0,2.0,2120,10202,1.0,0.0,0.0,4.0,1620,500,1960,2001,755000.0,Bellevue,98005,2120
3.0,2.0,2490,4343,2.0,0.0,0.0,3.0,2490,0,2003,0,705380.0,Issaquah,98029,2490
4.0,2.0,1990,7712,1.0,0.0,0.0,3.0,1210,780,1973,2013,627000.0,Issaquah,98027,1990
4.0,3.0,3690,9892,2.0,0.0,0.0,3.0,3690,0,1998,2006,865000.0,Sammamish,98075,3690
2.0,1.0,2540,7000,1.0,0.0,0.0,5.0,1320,1220,1942,0,580000.0,Seattle,98118,2540
4.0,3.0,2340,7048,1.0,0.0,0.0,4.0,1340,1000,1979,0,485000.0,Kirkland,98034,2340
2.0,2.0,2110,9519,1.0,0.0,0.0,2.0,2110,0,1948,0,400000.0,Shoreline,98155,2110
2.0,1.0,1140,5400,1.0,0.0,0.0,5.0,1140,0,1908,0,549000.0,Seattle,98112,1140
3.0,2.0,1480,2185,2.5,0.0,0.0,3.0,1480,0,2005,0,620000.0,Kirkland,98033,1480
2.0,3.0,1410,1240,2.0,0.0,0.0,3.0,1140,270,2006,0,405000.0,Seattle,98136,1410
2.0,1.0,1200,8063,1.0,0.0,0.0,4.0,1200,0,1958,1972,232000.0,DesMoines,98198,1200
5.0,2.0,3180,13806,2.0,0.0,0.0,4.0,3180,0,1990,0,800866.0,Kirkland,98033,3180
3.0,2.0,2160,9000,1.0,0.0,2.0,4.0,1400,760,1949,1985,650000.0,Seattle,98177,2160
6.0,2.0,2920,5000,2.5,0.0,0.0,4.0,2780,140,1908,0,823000.0,Seattle,98122,2920
3.0,2.0,2350,5700,1.5,0.0,0.0,4.0,1810,540,1939,1989,770000.0,Seattle,98112,2350
3.0,2.0,1560,5520,1.0,0.0,0.0,4.0,780,780,1944,0,524000.0,Seattle,98199,1560
5.0,3.0,2740,8426,1.0,0.0,0.0,4.0,1370,1370,1960,2001,541125.0,Bellevue,98006,2740
3.0,2.0,1680,2000,3.0,0.0,0.0,3.0,1680,0,1909,1998,670000.0,Seattle,98105,1680
5.0,2.0,3090,12750,1.0,0.0,0.0,3.0,1750,1340,1968,1997,384900.0,FederalWay,98023,3090
3.0,2.0,1410,1332,3.0,0.0,0.0,3.0,1410,0,2005,0,406100.0,Seattle,98103,1410
3.0,2.0,2010,6000,1.0,0.0,0.0,3.0,1330,680,1975,0,570000.0,Redmond,98052,2010
3.0,2.0,1330,7500,1.0,0.0,0.0,3.0,1330,0,1961,2004,787000.0,Bellevue,98004,1330
4.0,2.0,2370,6500,2.0,0.0,0.0,3.0,2370,0,1998,2006,328000.0,Auburn,98092,2370
5.0,2.0,1840,9240,1.0,0.0,0.0,4.0,1540,300,1942,1958,435000.0,Seattle,98133,1840
4.0,2.0,2910,6479,2.0,0.0,0.0,3.0,2910,0,2006,0,499000.0,Snoqualmie,98065,2910
4.0,1.0,2070,7519,1.0,0.0,0.0,3.0,1160,910,1963,2008,501000.0,Bellevue,98008,2070
2.0,1.0,840,5510,1.0,0.0,0.0,3.0,840,0,1955,2005,400000.0,Seattle,98136,840
4.0,2.0,1240,9600,1.0,0.0,0.0,3.0,1240,0,1971,0,220000.0,FederalWay,98023,1240
4.0,1.0,1390,4240,1.0,0.0,0.0,3.0,1050,340,1924,2011,657100.0,Seattle,98103,1390
4.0,3.0,2310,5000,2.0,0.0,0.0,3.0,2310,0,2006,0,309950.0,MapleValley,98038,2310
3.0,2.0,1050,10072,1.0,0.0,0.0,3.0,1050,0,1986,0,300000.0,Duvall,98019,1050
4.0,2.0,2010,3600,1.5,0.0,0.0,3.0,2010,0,1902,0,740000.0,Seattle,98119,2010
5.0,1.0,1120,9022,1.5,0.0,0.0,4.0,1120,0,1962,0,340000.0,Kirkland,98034,1120
3.0,2.0,2230,4000,2.0,0.0,0.0,3.0,2230,0,1954,2005,398750.0,Seattle,98144,2230
2.0,1.0,810,7158,1.0,0.0,0.0,5.0,810,0,1944,0,206000.0,Burien,98168,810
5.0,3.0,3190,16920,1.0,0.0,3.0,3.0,1690,1500,1976,0,1030000.0,Bellevue,98006,3190
4.0,2.0,1970,9389,1.0,0.0,0.0,5.0,1140,830,1960,0,379950.0,Shoreline,98133,1970
3.0,1.0,1450,6000,1.0,0.0,0.0,4.0,1450,0,1953,1983,287000.0,Seattle,98118,1450
3.0,2.0,1880,7838,2.0,0.0,0.0,3.0,1880,0,1994,0,309950.0,Renton,98055,1880
3.0,2.0,1880,6360,1.0,0.0,0.0,4.0,1040,840,1945,0,600000.0,Seattle,98115,1880
3.0,2.0,1410,6030,1.5,0.0,0.0,4.0,1410,0,1930,0,418000.0,Seattle,98103,1410
4.0,2.0,1480,3844,1.5,0.0,0.0,5.0,1480,0,1928,1970,449250.0,Seattle,98133,1480
2.0,1.0,1140,5250,1.5,0.0,0.0,4.0,1140,0,1949,1985,329950.0,Seattle,98133,1140
3.0,2.0,1920,9306,1.0,0.0,0.0,3.0,1000,920,1984,0,245000.0,Auburn,98001,1920
4.0,2.0,2910,6338,2.0,0.0,0.0,3.0,2910,0,2008,0,549000.0,Renton,98059,2910
3.0,2.0,3240,7857,2.0,0.0,0.0,3.0,3240,0,1994,0,800000.0,Sammamish,98075,3240
3.0,2.0,1550,15040,1.0,0.0,0.0,4.0,1550,0,1958,1972,249950.0,Renton,98059,1550
5.0,2.0,2050,10200,1.0,0.0,0.0,3.0,1430,620,1956,2001,210000.0,DesMoines,98198,2050
2.0,1.0,1770,8640,1.5,0.0,0.0,3.0,1520,250,1949,1998,585000.0,Seattle,98117,1770
4.0,2.0,2300,11700,1.0,0.0,0.0,4.0,1960,340,1977,0,615000.0,Redmond,98052,2300
3.0,2.0,1800,5000,1.0,0.0,0.0,4.0,1080,720,1942,1982,618500.0,Seattle,98115,1800
4.0,2.0,2010,9211,1.0,0.0,0.0,3.0,1470,540,1977,2004,487585.0,Kirkland,98034,2010
3.0,2.0,1790,2700,2.0,0.0,0.0,3.0,1790,0,2010,0,509900.0,Issaquah,98027,1790
4.0,2.0,2440,6651,2.0,0.0,0.0,3.0,2440,0,2014,0,631625.0,Seattle,98117,2440
3.0,2.0,1940,3211,2.0,0.0,0.0,3.0,1940,0,2009,0,555000.0,Issaquah,98027,1940
2.0,2.0,1160,1438,2.0,0.0,0.0,3.0,1160,0,2001,0,340000.0,Seattle,98144,1160
4.0,2.0,3400,9692,2.0,0.0,0.0,3.0,3400,0,2007,0,830000.0,Redmond,98052,3400
4.0,4.0,4420,5750,2.0,0.0,0.0,3.0,3410,1010,2006,0,890000.0,Issaquah,98027,4420
3.0,3.0,1571,2017,3.0,0.0,0.0,3.0,1571,0,2008,0,366750.0,Seattle,98125,1571
3.0,2.0,1620,998,2.5,0.0,0.0,3.0,1540,80,2010,0,415000.0,Issaquah,98029,1620
3.0,2.0,1408,989,3.0,0.0,0.0,3.0,1408,0,2005,0,416286.0,Seattle,98115,1408
3.0,2.0,3040,4535,2.0,0.0,0.0,3.0,3040,0,2007,0,478000.0,Renton,98056,3040
5.0,4.0,4490,6000,2.0,0.0,0.0,3.0,3200,1290,2006,0,890000.0,Issaquah,98027,4490
2.0,2.0,1590,1426,2.0,0.0,0.0,3.0,1590,0,2014,0,419190.0,Issaquah,98029,1590
4.0,2.0,1440,7680,1.0,0.0,0.0,3.0,1200,240,1971,0,397000.0,Kirkland,98034,1440
2.0,2.0,1100,3000,1.5,0.0,0.0,3.0,1100,0,1912,2005,450000.0,Seattle,98117,1100
3.0,1.0,1350,7740,1.0,0.0,0.0,4.0,860,490,1947,1988,353000.0,Seattle,98125,1350
3.0,2.0,1490,8366,1.0,0.0,0.0,4.0,1010,480,1975,0,234000.0,Covington,98042,1490
3.0,2.0,2000,7000,2.0,0.0,0.0,3.0,2000,0,1916,1986,561000.0,Seattle,98136,2000
2.0,1.0,1030,4400,1.0,0.0,0.0,3.0,1030,0,1924,2011,469000.0,Seattle,98117,1030
2.0,1.0,720,6687,1.0,0.0,0.0,3.0,720,0,1942,1999,329350.0,Seattle,98117,720
5.0,2.0,2020,5000,1.5,0.0,0.0,4.0,2020,0,1938,0,488000.0,Seattle,98117,2020
3.0,2.0,1580,8151,1.0,0.0,1.0,4.0,1100,480,1962,0,279900.0,DesMoines,98198,1580
4.0,2.0,2110,13850,2.0,0.0,0.0,3.0,2110,0,1987,2000,606000.0,Issaquah,98027,2110
4.0,2.0,1300,7054,1.0,0.0,0.0,3.0,1300,0,1950,2013,312000.0,Seattle,98146,1300
3.0,2.0,1630,7475,1.0,0.0,1.0,3.0,1160,470,1940,1996,650000.0,Seattle,98115,1630
4.0,3.0,3370,8103,1.0,0.0,3.0,3.0,1970,1400,1970,2014,1135000.0,Seattle,98136,3370
4.0,2.0,1890,6156,1.0,0.0,0.0,3.0,980,910,1980,0,325000.0,Seattle,98106,1890
4.0,2.0,1520,7983,1.0,0.0,0.0,5.0,1520,0,1967,0,425000.0,InglewoodFinnHill,98034,1520
2.0,1.0,900,5160,1.0,0.0,0.0,3.0,900,0,1952,2008,219000.0,Seattle,98106,900
3.0,1.0,1050,6874,1.0,0.0,0.0,3.0,1050,0,1954,2005,250000.0,Shoreline,98133,1050
3.0,2.0,1260,6500,1.0,0.0,0.0,4.0,1260,0,1966,0,390000.0,Bellevue,98008,1260
4.0,2.0,2290,12047,2.0,0.0,0.0,4.0,2290,0,1988,0,736000.0,Bellevue,98006,2290
3.0,2.0,1650,13816,2.0,0.0,0.0,3.0,1650,0,1998,2006,272000.0,Carnation,98014,1650
3.0,2.0,1640,14374,1.0,0.0,0.0,4.0,1140,500,1963,0,362000.0,Burien,98148,1640
3.0,2.0,1850,10109,2.0,0.0,0.0,3.0,1850,0,1991,0,535000.0,Kirkland,98034,1850
4.0,2.0,2000,5390,2.0,0.0,0.0,3.0,2000,0,2003,0,284000.0,Kent,98042,2000
3.0,2.0,1410,9647,1.0,0.0,0.0,3.0,1410,0,1961,2004,367500.0,Shoreline,98177,1410
4.0,2.0,1500,11600,1.0,0.0,0.0,4.0,1000,500,1955,2009,379900.0,Kenmore,98028,1500
3.0,1.0,1010,7034,1.0,0.0,0.0,3.0,1010,0,1954,2005,175000.0,Renton,98057,1010
4.0,2.0,2331,3826,2.0,0.0,0.0,3.0,2331,0,2007,0,345000.0,Renton,98058,2331
5.0,2.0,2240,7770,1.0,0.0,0.0,3.0,1340,900,1978,0,455000.0,Kirkland,98034,2240
4.0,3.0,2450,10117,1.0,0.0,0.0,5.0,1580,870,1967,0,610000.0,Bellevue,98006,2450
4.0,3.0,3100,15480,2.0,0.0,0.0,3.0,2400,700,1996,0,563000.0,Kenmore,98028,3100
4.0,2.0,2060,5000,1.0,0.0,0.0,3.0,1030,1030,1949,2013,612500.0,Seattle,98117,2060
3.0,2.0,1850,7684,1.0,0.0,0.0,3.0,1320,530,1979,2014,218000.0,FederalWay,98023,1850
4.0,2.0,1840,10720,1.0,0.0,0.0,3.0,960,880,1958,2004,404000.0,Bellevue,98008,1840
3.0,2.0,1420,8580,1.0,0.0,0.0,3.0,1420,0,1962,2003,136500.0,FederalWay,98023,1420
3.0,1.0,1510,6083,1.0,0.0,0.0,4.0,860,650,1940,2001,313950.0,Seattle,98115,1510
3.0,2.0,2130,6500,1.0,0.0,2.0,3.0,1170,960,1954,2005,575000.0,Seattle,98199,2130
3.0,2.0,1630,11800,1.0,0.0,0.0,4.0,1630,0,1971,0,280000.0,NorthBend,98045,1630
3.0,2.0,1790,7167,2.0,0.0,0.0,3.0,1790,0,1989,0,515000.0,Sammamish,98074,1790
4.0,2.0,2000,5684,2.0,0.0,0.0,3.0,2000,0,1996,0,513000.0,Kenmore,98028,2000
4.0,2.0,3030,7864,2.0,0.0,0.0,3.0,3030,0,1999,0,685000.0,Sammamish,98074,3030
3.0,2.0,1310,8160,1.0,0.0,0.0,3.0,1310,0,1950,2005,365000.0,Seattle,98133,1310
4.0,2.0,3880,14550,2.0,0.0,0.0,3.0,3880,0,1987,2000,762300.0,Sammamish,98074,3880
5.0,2.0,3040,8111,2.0,0.0,0.0,3.0,3040,0,1984,0,562000.0,Redmond,98052,3040
5.0,2.0,2910,9636,1.0,0.0,0.0,4.0,1690,1220,1964,0,530000.0,Bellevue,98008,2910
3.0,2.0,2970,11985,1.0,0.0,0.0,3.0,1770,1200,1995,0,525000.0,Sammamish,98074,2970
2.0,2.0,1660,6000,1.0,0.0,0.0,3.0,1160,500,1942,1999,484000.0,Seattle,98105,1660
4.0,2.0,3200,12369,2.0,0.0,0.0,3.0,3200,0,1998,2006,725126.0,Newcastle,98059,3200
4.0,2.0,2680,18768,1.0,0.0,0.0,5.0,2680,0,1965,0,360000.0,Auburn,98001,2680
3.0,1.0,1230,9568,1.0,0.0,0.0,5.0,1230,0,1962,0,387000.0,Newcastle,98056,1230
4.0,4.0,3380,8330,2.0,0.0,0.0,3.0,3380,0,2000,0,655500.0,Shoreline,98177,3380
3.0,1.0,1110,6250,1.0,0.0,0.0,3.0,1110,0,1956,2001,345000.0,Seattle,98115,1110
5.0,3.0,1800,3780,1.5,0.0,0.0,3.0,1400,400,1926,2003,533000.0,Seattle,98103,1800
3.0,2.0,1900,5520,1.0,0.0,0.0,3.0,1280,620,1982,0,385000.0,Seattle,98118,1900
3.0,2.0,1690,7735,1.0,0.0,0.0,4.0,1060,630,1976,1992,197000.0,Auburn,98001,1690
3.0,2.0,1420,4080,1.5,0.0,0.0,3.0,1420,0,1905,2013,485000.0,Seattle,98103,1420
3.0,2.0,1980,8000,1.0,0.0,0.0,4.0,1560,420,1974,0,295000.0,FederalWay,98023,1980
2.0,2.0,1170,2400,1.0,0.0,0.0,4.0,740,430,1903,0,499000.0,Seattle,98103,1170
3.0,2.0,2200,1970,2.0,0.0,0.0,3.0,1610,590,2008,0,1050000.0,Seattle,98102,2200
3.0,2.0,800,8850,1.0,0.0,0.0,4.0,800,0,1959,0,191000.0,FederalWay,98023,800
3.0,2.0,1480,1171,3.0,0.0,0.0,3.0,1480,0,2006,0,500000.0,Seattle,98112,1480
5.0,4.0,2890,5000,1.0,0.0,0.0,3.0,1310,1580,2006,0,390000.0,Seattle,98144,2890
3.0,2.0,2690,4047,3.0,0.0,0.0,3.0,2690,0,2014,0,979000.0,Seattle,98117,2690
3.0,2.0,1270,1320,3.0,0.0,0.0,3.0,1270,0,2006,0,369950.0,Seattle,98103,1270
4.0,2.0,3040,6425,2.0,0.0,0.0,3.0,3040,0,2008,0,776000.0,Redmond,98052,3040
3.0,2.0,1170,1249,3.0,0.0,0.0,3.0,1170,0,2014,0,519950.0,Seattle,98107,1170
5.0,2.0,2060,8632,1.0,0.0,0.0,3.0,1030,1030,1962,2003,255000.0,Burien,98146,2060
3.0,1.0,990,6000,1.0,0.0,0.0,3.0,990,0,1943,2002,495000.0,Seattle,98105,990
4.0,2.0,2430,5203,2.0,0.0,0.0,3.0,2430,0,2003,0,510000.0,Shoreline,98155,2430
3.0,2.0,1250,10122,1.0,0.0,0.0,3.0,1250,0,1994,0,253000.0,BlackDiamond,98010,1250
3.0,3.0,1540,6760,1.0,0.0,0.0,5.0,1210,330,1980,0,503000.0,Kirkland,98034,1540
3.0,2.0,1600,7000,2.0,0.0,0.0,4.0,1600,0,1993,0,275000.0,MapleValley,98038,1600
3.0,1.0,1110,8423,1.0,0.0,0.0,3.0,1110,0,1952,2008,249000.0,Burien,98166,1110
3.0,2.0,1840,10723,1.0,0.0,0.0,4.0,1220,620,1974,0,310000.0,Renton,98058,1840
3.0,3.0,2520,5401,1.0,0.0,0.0,4.0,1360,1160,1946,1989,750000.0,Seattle,98119,2520
9.0,4.0,3830,6988,2.5,0.0,0.0,3.0,2450,1380,1938,2003,599999.0,Seattle,98103,3830
4.0,3.0,2410,9549,1.0,0.0,0.0,4.0,1780,630,1956,0,758000.0,Kirkland,98033,2410
4.0,2.0,1720,10018,1.0,0.0,0.0,5.0,1720,0,1960,0,248500.0,Covington,98042,1720
3.0,2.0,1760,9055,2.0,0.0,0.0,4.0,1760,0,1985,0,460000.0,Redmond,98052,1760
3.0,2.0,1680,10500,1.0,0.0,0.0,4.0,1680,0,1959,0,675000.0,Bellevue,98005,1680
4.0,3.0,1830,9548,2.0,0.0,0.0,3.0,1830,0,1991,0,415000.0,Bothell,98028,1830
3.0,1.0,1400,7410,1.0,0.0,0.0,3.0,1400,0,1944,0,246000.0,Burien,98166,1400
3.0,2.0,1870,12381,1.0,0.0,0.0,4.0,1870,0,1957,2001,314500.0,FederalWay,98003,1870
2.0,2.0,1040,3500,1.5,0.0,0.0,4.0,1040,0,1904,0,420000.0,Seattle,98144,1040
3.0,1.0,1010,9360,1.0,0.0,0.0,3.0,1010,0,1981,2013,350000.0,Kirkland,98033,1010
3.0,2.0,1580,9147,1.0,0.0,1.0,4.0,1210,370,1967,0,515000.0,Bellevue,98008,1580
4.0,3.0,2600,6050,2.0,0.0,0.0,5.0,1960,640,1949,0,749950.0,Seattle,98116,2600
3.0,2.0,1920,9180,2.0,0.0,0.0,3.0,1920,0,1988,2000,230000.0,Renton,98057,1920
3.0,2.0,2350,5080,1.5,0.0,0.0,3.0,1780,570,1929,0,568000.0,Seattle,98118,2350
1.0,1.0,1100,4373,1.0,0.0,0.0,2.0,820,280,1947,0,250000.0,Burien,98166,1100
4.0,2.0,2510,13695,1.0,0.0,0.0,4.0,1280,1230,1961,2001,581000.0,Kirkland,98033,2510
2.0,1.0,1010,3885,1.5,0.0,0.0,4.0,1010,0,1906,1990,500000.0,Seattle,98112,1010
2.0,1.0,820,2723,1.0,0.0,0.0,3.0,820,0,1921,2000,475000.0,Seattle,98103,820
5.0,2.0,2420,8560,1.0,0.0,2.0,3.0,1620,800,1978,0,352000.0,Seattle,98118,2420
3.0,2.0,1770,8165,2.0,0.0,0.0,3.0,1770,0,1977,2004,420000.0,Kirkland,98034,1770
2.0,2.0,1350,3900,1.0,0.0,0.0,3.0,1350,0,2003,0,428000.0,Redmond,98053,1350
3.0,2.0,1960,4788,1.0,0.0,0.0,4.0,1090,870,1920,0,599000.0,Seattle,98115,1960
4.0,2.0,3305,16164,1.5,0.0,0.0,5.0,2245,1060,1922,1956,492000.0,Shoreline,98133,3305
2.0,2.0,2550,5663,1.0,0.0,0.0,3.0,1720,830,2011,0,630000.0,Renton,98056,2550
4.0,2.0,2310,13300,1.0,0.0,0.0,3.0,1890,420,1950,2005,1110000.0,ClydeHill,98004,2310
4.0,2.0,1650,5000,1.0,0.0,0.0,3.0,1650,0,1955,2005,575000.0,Seattle,98117,1650
4.0,2.0,2650,4316,1.5,0.0,0.0,3.0,1520,1130,1905,2013,705000.0,Seattle,98116,2650
4.0,2.0,1890,5940,1.0,0.0,1.0,3.0,1470,420,1963,2008,940000.0,Seattle,98112,1890
3.0,2.0,2190,8000,1.0,0.0,0.0,4.0,2190,0,1967,0,313000.0,FederalWay,98023,2190
3.0,2.0,2030,6500,2.0,0.0,0.0,3.0,2030,0,1988,2000,618080.0,Issaquah,98027,2030
3.0,3.0,2270,5175,2.0,0.0,0.0,3.0,2130,140,2002,0,640000.0,Renton,98056,2270
3.0,2.0,1610,4160,1.0,0.0,0.0,4.0,1010,600,1917,0,485000.0,Seattle,98136,1610
2.0,1.0,760,3001,1.0,0.0,0.0,3.0,760,0,1913,1983,300000.0,Seattle,98144,760
2.0,1.0,1640,17335,1.0,0.0,0.0,3.0,840,800,1978,0,379500.0,Redmond,98053,1640
3.0,2.0,1630,12295,2.0,0.0,0.0,4.0,1630,0,1985,0,339950.0,Renton,98058,1630
3.0,2.0,1410,7566,1.0,0.0,0.0,3.0,1410,0,1985,0,239900.0,Kent,98030,1410
3.0,1.0,1040,16986,1.0,0.0,0.0,4.0,1040,0,1968,0,314950.0,Renton,98059,1040
2.0,1.0,820,6400,1.0,0.0,0.0,4.0,820,0,1944,0,361280.0,Seattle,98126,820
7.0,6.0,3700,7647,2.0,0.0,1.0,3.0,3700,0,1948,1984,540000.0,LakeForestPark,98155,3700
4.0,2.0,2180,11200,1.0,0.0,0.0,4.0,2180,0,1968,0,480500.0,Woodinville,98072,2180
3.0,2.0,1600,4271,2.0,0.0,0.0,3.0,1600,0,2000,0,280000.0,Auburn,98001,1600
3.0,2.0,1500,6180,1.0,0.0,0.0,4.0,1060,440,1947,1988,440000.0,Seattle,98118,1500
3.0,1.0,1340,4284,1.0,0.0,0.0,3.0,1080,260,1910,2006,530000.0,Seattle,98105,1340
3.0,2.0,1860,13374,1.0,0.0,0.0,3.0,1860,0,1985,0,560000.0,Issaquah,98027,1860
3.0,2.0,2540,7200,1.5,0.0,3.0,4.0,1600,940,1905,0,775000.0,Seattle,98144,2540
2.0,1.0,1040,13100,1.0,0.0,0.0,5.0,1040,0,1912,0,160000.0,Kent,98032,1040
3.0,2.0,1380,11130,1.0,0.0,0.0,3.0,1380,0,1960,2012,209950.0,FederalWay,98003,1380
3.0,2.0,1640,10762,1.0,0.0,0.0,3.0,1130,510,1988,2000,226500.0,Covington,98042,1640
5.0,2.0,3000,6000,1.0,0.0,0.0,5.0,1500,1500,1958,0,380000.0,Seattle,98178,3000
4.0,3.0,2140,13000,1.0,0.0,0.0,3.0,1320,820,1968,1997,409500.0,Kenmore,98028,2140
3.0,2.0,1760,6428,1.0,0.0,0.0,4.0,980,780,1942,1982,690000.0,Seattle,98199,1760
3.0,2.0,1660,8307,1.0,0.0,0.0,4.0,1660,0,1961,2001,405000.0,Shoreline,98133,1660
3.0,2.0,1830,13042,2.0,0.0,0.0,3.0,1830,0,1990,2009,375000.0,MapleValley,98038,1830
4.0,2.0,2210,8556,1.0,0.0,1.0,4.0,1210,1000,1954,1979,794154.0,Seattle,98199,2210
4.0,1.0,1490,6600,1.0,0.0,0.0,3.0,1490,0,1969,2010,185000.0,Burien,98168,1490
3.0,2.0,1260,1270,2.0,0.0,0.0,3.0,1040,220,2005,0,245000.0,Seattle,98133,1260
4.0,4.0,3900,8391,2.0,0.0,0.0,3.0,3900,0,2006,0,1040000.0,Kirkland,98033,3900
2.0,2.0,1150,1027,3.0,0.0,0.0,3.0,1150,0,2008,0,425000.0,Seattle,98103,1150
5.0,3.0,2410,5003,1.0,0.0,0.0,3.0,1410,1000,2008,0,365000.0,Seattle,98118,2410
3.0,2.0,1606,1452,3.0,0.0,0.0,3.0,1606,0,2009,0,417250.0,Seattle,98125,1606
2.0,1.0,820,681,3.0,0.0,0.0,3.0,820,0,2006,0,339950.0,Seattle,98103,820
2.0,1.0,1540,6872,1.0,0.0,0.0,4.0,820,720,1946,1989,615000.0,Seattle,98119,1540
5.0,2.0,3160,11470,1.0,0.0,0.0,4.0,1780,1380,1971,0,980000.0,MercerIsland,98040,3160
4.0,2.0,1730,8320,1.0,0.0,0.0,3.0,1230,500,1977,2004,258000.0,FederalWay,98023,1730
3.0,1.0,1670,4080,1.0,0.0,0.0,3.0,1170,500,1967,2011,533000.0,Seattle,98115,1670
4.0,2.0,2550,4630,2.0,0.0,0.0,3.0,2550,0,2005,0,537500.0,Sammamish,98075,2550
5.0,3.0,3040,9601,1.0,0.0,0.0,5.0,1970,1070,1968,0,830000.0,MercerIsland,98040,3040
4.0,2.0,2020,6236,2.0,0.0,0.0,3.0,2020,0,2002,0,262000.0,Algona,98001,2020
4.0,2.0,2660,5500,2.0,0.0,2.0,3.0,2660,0,2003,0,753888.0,Issaquah,98029,2660
2.0,2.0,980,5000,2.0,0.0,0.0,3.0,980,0,1922,2003,134000.0,Skykomish,98288,980
3.0,2.0,1960,8000,1.0,0.0,0.0,4.0,1290,670,1977,0,402000.0,Kirkland,98034,1960
2.0,1.0,720,5040,1.0,0.0,0.0,3.0,720,0,1955,2005,205000.0,Seattle,98106,720
2.0,2.0,1360,1349,2.0,0.0,0.0,3.0,1050,310,1997,0,553650.0,Seattle,98112,1360
2.0,2.0,1870,4950,1.0,0.0,0.0,3.0,1870,0,2006,0,559950.0,Redmond,98053,1870
4.0,2.0,2130,8800,1.0,0.0,0.0,3.0,1100,1030,1962,2003,260000.0,Kent,98032,2130
4.0,2.0,1810,6509,2.0,0.0,0.0,3.0,1810,0,1994,0,270000.0,Kent,98042,1810
3.0,2.0,1690,4500,1.5,0.0,1.0,4.0,1690,0,1928,0,719000.0,Seattle,98116,1690
3.0,2.0,1940,8547,1.0,0.0,0.0,3.0,1460,480,1989,0,266000.0,Kent,98030,1940
4.0,1.0,3410,5000,2.0,0.0,0.0,5.0,2190,1220,1910,0,1039000.0,Seattle,98144,3410
3.0,2.0,1390,7399,1.0,0.0,0.0,4.0,1390,0,1975,0,246000.0,Kent,98031,1390
2.0,1.0,1060,4960,1.0,0.0,0.0,3.0,1060,0,1926,2003,515000.0,Seattle,98103,1060
3.0,1.0,1490,8995,1.0,0.0,0.0,4.0,1490,0,1954,1979,207000.0,Seattle,98168,1490
4.0,2.0,2480,9195,1.0,0.0,0.0,3.0,1390,1090,1950,2005,780000.0,Bellevue,98004,2480
3.0,2.0,1920,7229,2.0,0.0,0.0,3.0,1920,0,1993,0,295000.0,FederalWay,98003,1920
3.0,2.0,1890,9920,1.0,0.0,0.0,3.0,1230,660,1944,0,385000.0,Seattle,98125,1890
4.0,2.0,2250,13515,1.0,0.0,0.0,4.0,2150,100,1940,2001,350000.0,Kent,98030,2250
2.0,1.0,1270,3008,1.0,0.0,0.0,4.0,650,620,1923,0,235000.0,Seattle,98118,1270
2.0,2.0,960,1808,2.0,0.0,0.0,3.0,960,0,1993,0,358000.0,Seattle,98122,960
4.0,2.0,3290,6465,2.0,0.0,0.0,3.0,3290,0,2002,0,716500.0,Sammamish,98075,3290
4.0,2.0,2000,6120,1.0,0.0,0.0,3.0,1100,900,1965,1993,228000.0,Seattle,98178,2000
2.0,1.0,1020,8155,1.0,0.0,0.0,4.0,1020,0,1948,0,405000.0,Seattle,98177,1020
4.0,2.0,1840,9600,1.0,0.0,0.0,3.0,1220,620,1967,2011,538000.0,Redmond,98052,1840
3.0,2.0,1980,6760,1.0,0.0,0.0,4.0,1980,0,1973,0,530000.0,Bellevue,98008,1980
2.0,2.0,1230,3600,1.5,0.0,0.0,5.0,1230,0,1925,0,636000.0,Seattle,98119,1230
3.0,2.0,2920,3942,3.0,0.0,0.0,3.0,2920,0,2008,0,868500.0,Renton,98056,2920
4.0,3.0,2280,2850,1.5,0.0,0.0,4.0,1540,740,1930,0,530000.0,Seattle,98115,2280
3.0,2.0,950,6000,1.0,0.0,0.0,3.0,790,160,1939,1969,230000.0,Seattle,98108,950
3.0,2.0,1190,3000,2.0,0.0,0.0,3.0,1190,0,2002,0,229000.0,Tukwila,98178,1190
3.0,2.0,1310,9282,1.0,0.0,0.0,4.0,1310,0,1976,1992,437000.0,Redmond,98052,1310
3.0,2.0,1750,3354,2.0,0.0,0.0,4.0,1750,0,1991,0,595000.0,Kirkland,98033,1750
3.0,2.0,1320,5750,1.5,0.0,0.0,5.0,1320,0,1918,0,660000.0,Seattle,98116,1320
4.0,2.0,2460,7350,2.0,0.0,0.0,3.0,2460,0,1989,0,347500.0,FederalWay,98023,2460
3.0,2.0,1240,10800,1.0,0.0,0.0,3.0,1240,0,1967,2010,297950.0,Renton,98058,1240
3.0,2.0,1260,7964,1.0,0.0,0.0,4.0,1260,0,1955,2009,245000.0,DesMoines,98148,1260
6.0,2.0,2820,15600,1.5,0.0,2.0,5.0,1970,850,1940,0,543200.0,Burien,98166,2820
3.0,2.0,1540,1614,3.0,0.0,0.0,3.0,1470,70,2008,0,413450.0,Seattle,98103,1540
3.0,2.0,1460,7700,1.0,0.0,0.0,3.0,1460,0,1979,2014,424500.0,Redmond,98052,1460
3.0,1.0,1390,16000,1.0,0.0,0.0,4.0,1390,0,1960,2001,230000.0,Algona,98001,1390
3.0,3.0,2640,4080,2.0,0.0,0.0,3.0,1840,800,1912,2000,930000.0,Seattle,98105,2640
3.0,2.0,1590,9620,1.0,0.0,0.0,3.0,1590,0,1988,2000,349000.0,Renton,98059,1590
4.0,2.0,1910,6960,1.5,0.0,0.0,5.0,1910,0,1941,0,835000.0,Seattle,98103,1910
3.0,3.0,2015,16807,2.0,1.0,4.0,3.0,2015,0,2007,0,988500.0,Burien,98166,2015
2.0,2.0,1110,957,2.0,0.0,0.0,3.0,930,180,2005,0,499000.0,Seattle,98119,1110
2.0,1.0,860,1277,2.0,0.0,0.0,3.0,860,0,2007,0,321950.0,Seattle,98144,860
3.0,2.0,2310,4729,2.0,0.0,0.0,3.0,2310,0,2011,0,494000.0,Kenmore,98028,2310
2.0,2.0,1020,1060,3.0,0.0,0.0,3.0,1020,0,2008,0,441750.0,Seattle,98103,1020
2.0,1.0,980,1179,2.0,0.0,0.0,3.0,980,0,2010,0,438000.0,Seattle,98119,980
3.0,2.0,1640,11050,1.0,0.0,0.0,4.0,1640,0,1972,0,352000.0,Renton,98059,1640
4.0,3.0,2790,10819,2.0,0.0,0.0,3.0,2790,0,1996,0,765000.0,Issaquah,98027,2790
4.0,2.0,1750,5500,1.5,0.0,0.0,5.0,1050,700,1926,0,460000.0,Seattle,98117,1750
4.0,1.0,1430,8355,1.5,0.0,0.0,4.0,1430,0,1983,0,224500.0,Auburn,98092,1430
3.0,2.0,1850,4597,2.0,0.0,0.0,3.0,1850,0,2003,0,254000.0,Covington,98042,1850
4.0,3.0,3750,11025,2.0,0.0,0.0,3.0,3750,0,1976,0,920000.0,Sammamish,98074,3750
4.0,2.0,2600,11951,2.0,0.0,0.0,3.0,2600,0,1988,2000,402500.0,FederalWay,98023,2600
3.0,2.0,1390,8700,1.0,0.0,3.0,4.0,840,550,1912,1989,280950.0,Renton,98057,1390
4.0,2.0,2260,7753,2.0,0.0,0.0,3.0,2260,0,1989,0,604000.0,Issaquah,98029,2260
4.0,2.0,2470,7447,2.0,0.0,0.0,3.0,2470,0,1984,0,565000.0,LakeForestPark,98155,2470
2.0,1.0,810,7980,1.0,0.0,0.0,1.0,810,0,1928,0,255000.0,Seattle,98146,810
4.0,2.0,1650,6000,1.0,0.0,0.0,5.0,1000,650,1959,0,445000.0,Seattle,98144,1650
2.0,1.0,720,18000,1.0,0.0,0.0,3.0,720,0,1950,2005,195000.0,Seattle,98178,720
3.0,2.0,1445,1606,2.0,0.0,0.0,3.0,1300,145,2003,0,387000.0,Issaquah,98027,1445
2.0,1.0,1840,3300,1.5,0.0,0.0,4.0,1130,710,1910,0,490000.0,Seattle,98107,1840
3.0,2.0,2100,5824,2.0,0.0,2.0,3.0,2100,0,1999,0,505000.0,Snoqualmie,98065,2100
3.0,2.0,1060,10464,1.0,0.0,0.0,4.0,1060,0,1973,0,303500.0,Kirkland,98034,1060
3.0,2.0,1500,6337,1.0,0.0,0.0,5.0,1500,0,1953,0,270000.0,Seattle,98125,1500
4.0,3.0,1970,7213,1.0,0.0,0.0,3.0,1170,800,1977,2004,323000.0,Renton,98058,1970
3.0,3.0,1410,1253,3.0,0.0,0.0,3.0,1410,0,2005,0,382000.0,Seattle,98103,1410
4.0,2.0,2190,14439,1.0,0.0,0.0,4.0,1180,1010,1977,0,280000.0,Auburn,98001,2190
3.0,2.0,1920,8075,1.0,0.0,0.0,4.0,1510,410,1969,0,260000.0,FederalWay,98023,1920
3.0,1.0,1160,8320,1.0,0.0,0.0,4.0,1160,0,1959,0,201500.0,Kent,98032,1160
4.0,2.0,2000,4000,1.5,0.0,0.0,5.0,1450,550,1926,0,536500.0,Seattle,98126,2000
4.0,3.0,2163,5883,2.0,0.0,0.0,3.0,2163,0,2006,0,248000.0,Algona,98001,2163
4.0,2.0,2840,6268,2.0,0.0,0.0,3.0,2840,0,1998,2006,580000.0,Kenmore,98028,2840
2.0,1.0,1150,4400,1.0,0.0,0.0,4.0,1150,0,1905,0,463000.0,Seattle,98112,1150
4.0,3.0,3100,3773,2.0,0.0,0.0,3.0,2000,1100,1919,1996,742500.0,Seattle,98122,3100
3.0,2.0,1420,14850,1.0,0.0,0.0,4.0,1020,400,1963,0,260000.0,Kent,98032,1420
4.0,2.0,1930,7452,1.0,0.0,0.0,3.0,1430,500,1984,0,312000.0,Kent,98031,1930
3.0,2.0,1660,10140,1.0,0.0,0.0,4.0,1370,290,1980,0,566000.0,Redmond,98052,1660
3.0,2.0,1400,7293,1.0,0.0,0.0,4.0,1400,0,1963,0,511555.0,Bellevue,98008,1400
4.0,2.0,2660,4000,2.0,0.0,0.0,3.0,2660,0,2001,0,583000.0,Redmond,98053,2660
4.0,2.0,2000,13300,1.0,0.0,0.0,4.0,1200,800,1968,0,290000.0,Auburn,98001,2000
4.0,2.0,2130,8078,1.0,0.0,0.0,4.0,1380,750,1977,0,311100.0,Renton,98055,2130
3.0,2.0,1352,1694,3.0,0.0,0.0,3.0,1352,0,2007,0,325000.0,Seattle,98125,1352
3.0,2.0,1750,11340,1.0,0.0,1.0,4.0,1300,450,1987,0,491300.0,Sammamish,98074,1750
5.0,2.0,2320,8100,1.0,0.0,0.0,4.0,1160,1160,1956,0,315000.0,Burien,98166,2320
4.0,2.0,1940,3784,2.0,0.0,0.0,3.0,1940,0,2003,0,330000.0,Renton,98058,1940
3.0,2.0,1410,4800,1.0,0.0,0.0,3.0,1410,0,1940,1996,481450.0,Seattle,98117,1410
3.0,1.0,1360,9948,1.0,0.0,0.0,3.0,1360,0,1977,2004,234950.0,BlackDiamond,98010,1360
3.0,2.0,1220,7250,1.0,0.0,0.0,3.0,1220,0,1962,2003,251000.0,NorthBend,98045,1220
4.0,3.0,3780,10308,2.0,0.0,0.0,3.0,3780,0,1999,0,833000.0,Sammamish,98075,3780
4.0,2.0,2330,14289,2.0,0.0,0.0,4.0,2330,0,1978,2000,542500.0,Bellevue,98007,2330
3.0,1.0,1030,6127,1.0,0.0,0.0,3.0,880,150,1947,2012,252500.0,Seattle,98125,1030
4.0,2.0,1930,9653,1.0,0.0,0.0,4.0,1930,0,1968,0,465000.0,FederalWay,98023,1930
3.0,2.0,2000,9202,2.0,0.0,0.0,4.0,2000,0,1992,0,225000.0,MapleValley,98038,2000
3.0,2.0,1690,9583,1.0,0.0,0.0,4.0,1690,0,1969,0,270000.0,Renton,98059,1690
3.0,2.0,1300,5413,1.5,0.0,0.0,3.0,1300,0,1925,1992,536000.0,Seattle,98115,1300
2.0,2.0,1150,6634,1.0,0.0,0.0,3.0,860,290,1940,1996,445000.0,Seattle,98115,1150
4.0,2.0,2310,7490,2.0,0.0,0.0,3.0,2310,0,1980,0,320000.0,Renton,98055,2310
4.0,4.0,2730,3047,2.0,0.0,0.0,3.0,2400,330,2006,0,769900.0,Seattle,98116,2730
3.0,2.0,1340,1384,3.0,0.0,0.0,3.0,1340,0,2008,0,376000.0,Seattle,98103,1340
3.0,2.0,998,904,2.0,0.0,0.0,3.0,798,200,2007,0,324000.0,Seattle,98117,998
5.0,3.0,3060,7015,1.0,0.0,0.0,5.0,1600,1460,1979,0,549900.0,Seattle,98146,3060
3.0,2.0,2130,6969,2.0,0.0,0.0,3.0,2130,0,2003,0,320000.0,MapleValley,98038,2130
4.0,2.0,2520,6000,1.0,0.0,0.0,3.0,1400,1120,1921,2007,875000.0,Seattle,98103,2520
4.0,1.0,1940,9533,1.0,0.0,0.0,3.0,1080,860,1962,2003,265000.0,Kent,98031,1940
3.0,2.0,1350,1250,3.0,0.0,0.0,3.0,1270,80,2006,0,394950.0,Seattle,98136,1350
4.0,2.0,2160,5298,2.5,0.0,0.0,4.0,2160,0,1902,0,842500.0,Seattle,98122,2160
3.0,2.0,1370,1350,2.0,0.0,0.0,3.0,1010,360,2007,0,368000.0,Seattle,98136,1370
4.0,2.0,2830,5000,2.0,0.0,0.0,3.0,2830,0,1995,0,885000.0,Seattle,98105,2830
3.0,2.0,2010,2287,2.0,0.0,0.0,3.0,1390,620,2014,0,453246.0,Issaquah,98029,2010
4.0,3.0,3300,12090,2.0,0.0,0.0,3.0,3300,0,1953,0,927000.0,ClydeHill,98004,3300
3.0,2.0,1720,7119,1.5,0.0,0.0,4.0,1720,0,1952,0,341000.0,Shoreline,98155,1720
1.0,1.0,810,2451,1.0,0.0,0.0,5.0,810,0,1941,0,235000.0,Seattle,98126,810
2.0,1.0,1220,2500,1.0,0.0,0.0,3.0,770,450,1910,2006,255000.0,Seattle,98126,1220
3.0,3.0,2170,12508,1.5,0.0,0.0,5.0,1650,520,1928,1970,876650.0,MercerIsland,98040,2170
2.0,1.0,910,4500,1.5,0.0,0.0,4.0,910,0,1906,1990,350000.0,Seattle,98118,910
4.0,2.0,2980,4930,2.0,0.0,0.0,3.0,2890,90,2000,0,750000.0,Bellevue,98006,2980
4.0,2.0,2120,4650,1.0,0.0,1.0,3.0,1190,930,1951,1994,582000.0,Seattle,98117,2120
3.0,2.0,2200,16921,2.0,0.0,0.0,3.0,2200,0,1987,2000,410000.0,MapleValley,98038,2200
4.0,2.0,1730,5500,1.0,0.0,0.0,5.0,1010,720,1943,0,360000.0,Seattle,98106,1730
3.0,1.0,990,8012,1.0,0.0,0.0,4.0,990,0,1966,0,225000.0,Renton,98058,990
4.0,2.0,3040,6887,2.0,0.0,0.0,3.0,3040,0,1999,0,647000.0,Sammamish,98074,3040
3.0,2.0,1370,8470,1.0,0.0,0.0,4.0,1370,0,1961,2001,185000.0,Auburn,98092,1370
4.0,2.0,1800,8623,1.0,0.0,0.0,4.0,1360,440,1980,0,522000.0,Kirkland,98033,1800
3.0,2.0,1720,5000,1.0,0.0,0.0,3.0,1720,0,1954,2014,770000.0,Seattle,98122,1720
3.0,1.0,980,6380,1.0,0.0,0.0,3.0,760,220,1941,1994,499950.0,Seattle,98115,980
3.0,2.0,2020,11358,1.0,0.0,0.0,4.0,1190,830,1956,0,465000.0,Kirkland,98033,2020
4.0,2.0,2350,11914,1.0,0.0,0.0,4.0,2350,0,1961,2001,850000.0,MercerIsland,98040,2350
4.0,2.0,3290,12329,1.5,0.0,0.0,4.0,3290,0,1968,0,947500.0,MercerIsland,98040,3290
5.0,2.0,2180,7813,2.0,0.0,0.0,3.0,2180,0,1986,0,302000.0,MapleValley,98038,2180
2.0,2.0,1290,1334,3.0,0.0,0.0,3.0,1290,0,2007,0,500000.0,Seattle,98107,1290
3.0,1.0,1460,9750,1.0,0.0,0.0,4.0,1460,0,1969,0,201000.0,Kent,98042,1460
2.0,1.0,1290,2828,2.0,0.0,0.0,3.0,1290,0,2008,0,265000.0,Redmond,98053,1290
4.0,2.0,2350,3150,1.5,0.0,0.0,4.0,1690,660,1910,0,870300.0,Seattle,98103,2350
3.0,1.0,1080,8100,1.0,0.0,0.0,4.0,1080,0,1955,2009,339000.0,Shoreline,98155,1080
4.0,2.0,2670,13463,2.0,0.0,0.0,4.0,2670,0,1989,0,690000.0,Issaquah,98029,2670
4.0,3.0,3680,5759,2.0,0.0,0.0,3.0,2840,840,2003,0,788000.0,Issaquah,98027,3680
3.0,2.0,1440,8040,1.0,0.0,0.0,3.0,960,480,1951,1994,315275.0,Seattle,98125,1440
4.0,2.0,1940,4800,1.0,0.0,0.0,5.0,1030,910,1922,1956,505000.0,Seattle,98122,1940
3.0,1.0,1280,9898,1.0,0.0,0.0,3.0,1280,0,1968,1997,368000.0,Woodinville,98072,1280
3.0,1.0,970,8580,1.0,0.0,0.0,3.0,970,0,1959,1989,156000.0,FederalWay,98003,970
4.0,3.0,2110,5000,1.5,0.0,2.0,4.0,1640,470,1930,0,610000.0,Seattle,98136,2110
2.0,2.0,1480,1369,3.0,0.0,0.0,3.0,1480,0,2009,0,420000.0,Redmond,98052,1480
2.0,1.0,700,10540,1.0,0.0,0.0,3.0,700,0,1953,0,192000.0,NormandyPark,98166,700
3.0,2.0,2700,6120,1.0,0.0,0.0,4.0,1350,1350,1962,0,910000.0,Seattle,98115,2700
4.0,3.0,2600,2750,1.5,0.0,0.0,3.0,1620,980,1936,0,840000.0,Seattle,98109,2600
2.0,2.0,1360,8100,1.0,0.0,0.0,3.0,860,500,1975,0,300000.0,Seattle,98177,1360
4.0,2.0,2780,6369,1.0,0.0,0.0,3.0,1590,1190,1978,0,505000.0,Kirkland,98034,2780
3.0,2.0,2620,8950,2.0,0.0,0.0,3.0,2620,0,1992,0,746000.0,Bellevue,98006,2620
3.0,2.0,1350,7620,1.0,0.0,0.0,5.0,1350,0,1941,0,211000.0,Burien,98166,1350
4.0,3.0,2400,3340,1.0,0.0,0.0,4.0,1200,1200,1964,0,675000.0,Seattle,98107,2400
4.0,2.0,2760,5000,1.5,0.0,0.0,5.0,1680,1080,1928,1970,734200.0,Seattle,98107,2760
4.0,2.0,1770,6000,2.0,0.0,0.0,5.0,1770,0,1911,1981,630000.0,Seattle,98199,1770
2.0,2.0,830,1333,2.0,0.0,0.0,3.0,830,0,2005,0,301500.0,Seattle,98136,830
2.0,2.0,980,895,2.0,0.0,0.0,3.0,670,310,2009,0,369000.0,Seattle,98116,980
3.0,2.0,1570,1433,3.0,0.0,0.0,3.0,1570,0,2010,0,635000.0,Seattle,98103,1570
4.0,3.0,3270,5187,2.0,0.0,0.0,3.0,3110,160,2014,0,1033888.0,Redmond,98052,3270
4.0,2.0,2160,6223,2.0,0.0,0.0,3.0,2160,0,2010,0,383000.0,MapleValley,98038,2160
4.0,4.0,3280,11000,2.0,0.0,0.0,3.0,2320,960,2008,0,1050000.0,Kirkland,98033,3280
4.0,2.0,3360,7685,2.0,0.0,0.0,3.0,3360,0,2001,0,455000.0,Renton,98058,3360
3.0,4.0,1810,1846,2.0,0.0,0.0,4.0,1440,370,2009,0,625000.0,Seattle,98122,1810
4.0,2.0,2740,7140,2.0,0.0,0.0,3.0,2740,0,1993,0,651000.0,Sammamish,98074,2740
3.0,3.0,3190,5283,2.0,0.0,0.0,3.0,3190,0,2007,0,757000.0,Issaquah,98029,3190
3.0,2.0,2350,10450,1.0,0.0,0.0,3.0,1390,960,1977,2004,460000.0,Kenmore,98028,2350
4.0,2.0,2510,8165,1.0,0.0,0.0,4.0,1610,900,1972,0,267345.0,FederalWay,98023,2510
2.0,2.0,1680,4950,1.0,0.0,0.0,3.0,1680,0,2006,0,530000.0,Redmond,98053,1680
3.0,2.0,1770,6610,1.0,0.0,0.0,4.0,960,810,1954,1979,449500.0,Shoreline,98133,1770
3.0,1.0,1090,7315,1.0,0.0,0.0,5.0,1090,0,1981,0,289000.0,Renton,98056,1090
5.0,2.0,3001,5710,2.0,0.0,0.0,3.0,3001,0,2006,0,373000.0,Kent,98030,3001
5.0,3.0,2450,4591,2.0,0.0,0.0,3.0,2450,0,1994,0,525000.0,Seattle,98117,2450
4.0,2.0,2250,7500,1.0,0.0,0.0,5.0,1200,1050,1956,0,550000.0,Bellevue,98005,2250
3.0,2.0,1240,7735,1.0,0.0,0.0,4.0,1240,0,1957,2001,523000.0,Bellevue,98008,1240
4.0,2.0,2260,6000,1.0,0.0,0.0,3.0,1430,830,1958,2004,628000.0,Seattle,98115,2260
4.0,2.0,2090,8164,1.0,0.0,0.0,4.0,1070,1020,1963,0,581000.0,Redmond,98052,2090
5.0,2.0,2020,7902,1.0,0.0,0.0,3.0,1220,800,1962,2003,245000.0,Seattle,98168,2020
3.0,2.0,1960,5000,1.0,0.0,0.0,5.0,980,980,1911,1984,415000.0,Seattle,98108,1960
3.0,2.0,1250,7500,1.0,0.0,0.0,3.0,1250,0,1967,2011,225000.0,Kent,98030,1250
3.0,2.0,1490,9600,1.0,0.0,0.0,4.0,1170,320,1987,0,287000.0,Duvall,98019,1490
6.0,3.0,2890,2370,2.5,0.0,0.0,3.0,2290,600,1906,2014,799200.0,Seattle,98102,2890
3.0,2.0,1680,2400,1.0,0.0,0.0,5.0,870,810,1922,1956,591000.0,Seattle,98122,1680
3.0,2.0,2030,8398,2.0,0.0,0.0,4.0,2030,0,1975,0,700000.0,Bellevue,98008,2030
3.0,2.0,1580,11750,1.0,0.0,0.0,4.0,1180,400,1951,1999,575000.0,Seattle,98118,1580
3.0,2.0,1780,6120,1.5,0.0,0.0,4.0,1390,390,1927,0,771000.0,Seattle,98122,1780
2.0,1.0,910,6232,1.0,0.0,0.0,3.0,910,0,1943,2002,155000.0,Seattle,98118,910
7.0,4.0,3440,8100,2.0,0.0,0.0,3.0,3440,0,1970,2014,550000.0,Seattle,98103,3440
3.0,2.0,1740,13750,2.0,0.0,0.0,4.0,1740,0,1975,0,645000.0,Bellevue,98008,1740
5.0,2.0,3400,8970,1.0,0.0,0.0,4.0,1700,1700,1959,0,464000.0,Shoreline,98133,3400
4.0,3.0,4400,16625,2.0,0.0,0.0,3.0,4400,0,2003,0,1050000.0,Sammamish,98075,4400
3.0,2.0,2010,14298,2.0,0.0,0.0,3.0,2010,0,1977,2004,350000.0,Vashon,98070,2010
3.0,2.0,1310,3880,1.0,0.0,0.0,3.0,1090,220,1956,2001,717000.0,Seattle,98117,1310
4.0,2.0,1950,12559,1.5,0.0,0.0,3.0,1950,0,1939,1969,225000.0,SeaTac,98188,1950
3.0,1.0,1040,6535,1.0,0.0,0.0,3.0,1040,0,1947,2012,225000.0,Seattle,98168,1040
3.0,2.0,1090,7200,1.0,0.0,0.0,3.0,1090,0,1968,1997,345000.0,Kirkland,98034,1090
2.0,1.0,650,5360,1.0,0.0,0.0,4.0,650,0,1931,0,230000.0,Seattle,98133,650
3.0,2.0,1480,6600,1.0,0.0,2.0,3.0,740,740,1943,2002,385000.0,Seattle,98146,1480
2.0,1.0,790,2640,1.0,0.0,0.0,3.0,790,0,1973,2013,90000.0,Kirkland,98034,790
4.0,2.0,3560,11119,1.0,0.0,2.0,3.0,2290,1270,1986,0,860000.0,Bellevue,98004,3560
4.0,2.0,3000,5548,2.0,0.0,0.0,3.0,3000,0,2006,0,675000.0,Newcastle,98056,3000
4.0,2.0,3490,7494,2.0,0.0,3.0,3.0,3490,0,2000,0,975000.0,Bellevue,98006,3490
3.0,2.0,2340,10495,1.0,0.0,0.0,4.0,2340,0,1967,0,780000.0,MercerIsland,98040,2340
3.0,2.0,1650,8254,1.0,0.0,0.0,5.0,1060,590,1951,0,370000.0,Shoreline,98155,1650
3.0,2.0,1940,5820,1.5,0.0,0.0,5.0,1150,790,1944,0,665000.0,Seattle,98107,1940
5.0,3.0,3410,9600,1.0,0.0,0.0,4.0,1870,1540,1968,0,675000.0,Redmond,98052,3410
3.0,1.0,1710,4050,1.5,0.0,0.0,3.0,1710,0,1909,2004,620000.0,Seattle,98103,1710
4.0,2.0,2740,4000,2.0,0.0,0.0,5.0,1930,810,1905,0,1105000.0,Seattle,98109,2740
3.0,3.0,1250,892,2.0,0.0,0.0,3.0,1040,210,2010,0,450000.0,Seattle,98116,1250
3.0,2.0,1690,8190,1.0,0.0,0.0,4.0,1690,0,1958,1972,530000.0,Bellevue,98005,1690
4.0,2.0,1950,13320,1.0,0.0,0.0,4.0,1370,580,1969,0,635000.0,Bellevue,98007,1950
5.0,2.0,2290,7125,1.0,0.0,0.0,3.0,1190,1100,1964,2000,580000.0,Bellevue,98008,2290
3.0,1.0,1090,8640,1.0,0.0,0.0,4.0,1090,0,1973,0,285000.0,Burien,98166,1090
3.0,1.0,1190,9486,1.0,0.0,0.0,4.0,1190,0,1953,1983,375000.0,NormandyPark,98166,1190
3.0,1.0,1440,5000,2.0,0.0,0.0,3.0,1440,0,1910,2006,560000.0,Seattle,98103,1440
4.0,2.0,2180,13529,1.0,0.0,0.0,3.0,1090,1090,1956,2001,405000.0,LakeForestPark,98155,2180
4.0,1.0,1410,6000,1.0,0.0,0.0,3.0,810,600,1925,2002,413000.0,Seattle,98126,1410
3.0,2.0,1950,8251,2.0,0.0,0.0,3.0,1950,0,1990,2009,287600.0,Auburn,98001,1950
3.0,1.0,1660,7210,1.0,0.0,0.0,3.0,1100,560,1963,2008,225000.0,Auburn,98001,1660
3.0,1.0,1390,12823,1.0,0.0,0.0,4.0,1390,0,1968,0,319000.0,Woodinville,98077,1390
3.0,2.0,1350,14200,1.0,0.0,0.0,3.0,1350,0,1989,0,322500.0,Duvall,98019,1350
3.0,2.0,1530,5401,1.0,0.0,0.0,4.0,1530,0,1937,0,570000.0,Seattle,98115,1530
3.0,2.0,1270,5112,1.0,0.0,0.0,3.0,1270,0,1950,2005,465000.0,Seattle,98115,1270
4.0,2.0,2140,6355,2.0,0.0,0.0,3.0,2140,0,2002,0,435000.0,Snoqualmie,98065,2140
3.0,4.0,2876,5086,2.0,0.0,0.0,3.0,2360,516,2007,0,525000.0,Woodinville,98072,2876
3.0,2.0,1580,1161,2.0,0.0,0.0,3.0,1010,570,2008,0,525000.0,Seattle,98112,1580
4.0,2.0,3520,6773,2.5,0.0,0.0,3.0,2650,870,2006,0,870000.0,Seattle,98136,3520
4.0,2.0,2790,5602,2.0,0.0,0.0,3.0,2790,0,2009,0,505000.0,Renton,98059,2790
3.0,2.0,1450,5008,1.0,0.0,0.0,3.0,840,610,2007,0,330000.0,Seattle,98106,1450
4.0,2.0,1620,4980,1.0,0.0,0.0,4.0,860,760,1947,1988,385000.0,Seattle,98133,1620
3.0,2.0,1220,1086,3.0,0.0,0.0,3.0,1220,0,2007,0,306000.0,Seattle,98133,1220
3.0,2.0,2000,5000,1.0,0.0,0.0,4.0,1110,890,1921,0,546000.0,Seattle,98117,2000
4.0,2.0,2190,7350,2.5,0.0,0.0,5.0,2190,0,1958,0,925000.0,MercerIsland,98040,2190
4.0,2.0,1900,8250,1.0,0.0,0.0,4.0,950,950,1955,2009,542000.0,Bellevue,98006,1900
3.0,1.0,1700,4400,1.5,0.0,0.0,4.0,1700,0,1906,1990,800000.0,Seattle,98122,1700
5.0,2.0,2540,3832,2.0,0.0,0.0,5.0,1760,780,1929,0,620000.0,Seattle,98117,2540
2.0,1.0,1170,8925,1.0,0.0,2.0,3.0,1170,0,1911,1979,175000.0,DesMoines,98198,1170
3.0,2.0,2120,15003,2.0,0.0,0.0,3.0,2120,0,1984,0,345000.0,Renton,98059,2120
4.0,3.0,2450,15002,1.0,0.0,0.0,5.0,2450,0,1974,0,530000.0,NormandyPark,98166,2450
2.0,1.0,700,5200,1.0,0.0,0.0,5.0,700,0,1952,1998,155000.0,Renton,98056,700
3.0,2.0,1780,7214,1.0,0.0,0.0,4.0,1400,380,1986,0,266000.0,Kent,98030,1780
3.0,2.0,1850,8250,1.0,0.0,0.0,4.0,1150,700,1952,0,257200.0,Auburn,98002,1850
3.0,2.0,1570,5706,1.0,0.0,0.0,3.0,1570,0,1998,2006,265000.0,Auburn,98092,1570
3.0,1.0,1290,5500,1.0,0.0,0.0,3.0,980,310,1951,1994,372220.0,Seattle,98136,1290
5.0,2.0,1700,7314,1.0,0.0,0.0,3.0,1000,700,1956,2001,337500.0,Seattle,98108,1700
2.0,2.0,1159,4800,1.0,0.0,0.0,3.0,1159,0,1948,1994,582500.0,Seattle,98199,1159
3.0,3.0,1850,9600,1.5,0.0,0.0,5.0,1850,0,1965,0,489200.0,Kirkland,98034,1850
2.0,1.0,840,3522,1.0,0.0,0.0,3.0,840,0,1947,2012,405100.0,Seattle,98199,840
3.0,2.0,1690,1618,2.0,0.0,0.0,3.0,1150,540,2014,0,372977.0,Issaquah,98029,1690
3.0,1.0,1050,9876,1.0,0.0,0.0,3.0,1050,0,1953,0,310000.0,Kenmore,98028,1050
3.0,2.0,1400,3825,1.5,0.0,0.0,4.0,1100,300,1904,0,538000.0,Seattle,98117,1400
3.0,2.0,2360,6750,2.0,0.0,0.0,5.0,1930,430,1926,0,702500.0,Seattle,98103,2360
4.0,2.0,2240,14667,2.0,0.0,0.0,4.0,2240,0,1989,0,565000.0,Newcastle,98059,2240
3.0,2.0,1830,5120,1.5,0.0,2.0,5.0,1830,0,1903,0,682000.0,Seattle,98122,1830
3.0,2.0,2220,6049,2.0,0.0,0.0,4.0,2220,0,1990,0,325000.0,Kent,98031,2220
3.0,2.0,2090,7640,1.0,0.0,0.0,3.0,1360,730,1962,2014,543000.0,Shoreline,98133,2090
3.0,2.0,1600,6120,1.5,0.0,0.0,3.0,1600,0,1924,2011,525000.0,Seattle,98115,1600
4.0,2.0,2010,8625,1.0,0.0,0.0,4.0,1340,670,1957,2001,364000.0,Shoreline,98133,2010
2.0,1.0,830,4000,1.0,0.0,0.0,3.0,830,0,1955,2005,394475.0,Seattle,98117,830
4.0,2.0,2010,7226,2.0,0.0,0.0,3.0,2010,0,1995,0,316000.0,Auburn,98092,2010
3.0,1.0,1050,5402,1.5,0.0,0.0,4.0,1050,0,1906,1990,339950.0,Seattle,98144,1050
3.0,1.0,860,11900,1.0,0.0,0.0,4.0,860,0,1963,0,160000.0,Kent,98030,860
3.0,1.0,1100,17334,1.0,0.0,0.0,3.0,1100,0,1978,0,139000.0,Auburn,98001,1100
3.0,2.0,1830,8000,1.0,0.0,0.0,4.0,1830,0,1957,2001,562000.0,Bellevue,98008,1830
3.0,2.0,1820,4883,2.0,0.0,0.0,3.0,1820,0,2005,0,511000.0,Kenmore,98028,1820
3.0,4.0,2100,12384,2.0,0.0,0.0,3.0,2100,0,1980,0,356000.0,Tukwila,98168,2100
4.0,2.0,2310,14023,2.0,0.0,0.0,3.0,2310,0,1991,0,470000.0,Duvall,98019,2310
4.0,2.0,2060,5649,1.0,0.0,0.0,5.0,1360,700,1941,0,715000.0,Seattle,98199,2060
3.0,1.0,1660,7500,1.0,0.0,0.0,4.0,1060,600,1940,2001,458000.0,Seattle,98125,1660
5.0,4.0,3810,8019,2.0,0.0,0.0,3.0,3810,0,2008,0,966000.0,Sammamish,98075,3810
3.0,2.0,2110,10200,2.0,0.0,0.0,4.0,2110,0,1966,0,305495.0,Renton,98059,2110
3.0,2.0,1970,3716,2.0,0.0,0.0,3.0,1970,0,1997,0,340000.0,Renton,98056,1970
3.0,1.0,1480,7830,1.0,0.0,0.0,3.0,1480,0,1952,2008,310000.0,Shoreline,98133,1480
5.0,3.0,2257,10117,1.0,0.0,0.0,3.0,1363,894,2005,0,349950.0,SeaTac,98188,2257
2.0,1.0,700,6000,1.0,0.0,0.0,4.0,700,0,1949,1985,267800.0,Shoreline,98155,700
4.0,2.0,1630,9010,1.0,0.0,0.0,4.0,1050,580,1975,0,234000.0,Auburn,98092,1630
4.0,2.0,3430,10157,2.0,0.0,0.0,3.0,3430,0,2000,0,740000.0,Kirkland,98034,3430
5.0,2.0,2220,6000,1.5,0.0,0.0,3.0,1420,800,1923,1998,607500.0,Seattle,98199,2220
3.0,2.0,1340,7473,1.0,0.0,0.0,4.0,1340,0,1973,0,223000.0,Auburn,98002,1340
2.0,1.0,980,2130,1.0,0.0,0.0,4.0,860,120,1918,1974,400000.0,Seattle,98117,980
3.0,2.0,2580,13096,2.0,0.0,0.0,3.0,2580,0,1986,0,802000.0,Redmond,98052,2580
4.0,2.0,2230,4541,2.0,0.0,0.0,3.0,2230,0,2006,0,253000.0,Covington,98042,2230
4.0,2.0,2290,11137,1.0,0.0,0.0,4.0,2290,0,1955,2009,1058000.0,Bellevue,98004,2290
3.0,1.0,1260,8280,1.0,0.0,0.0,3.0,1260,0,1946,0,300000.0,Seattle,98115,1260
4.0,3.0,1680,11180,1.0,0.0,0.0,4.0,1680,0,1966,0,625000.0,Redmond,98052,1680
4.0,2.0,3320,7644,2.0,0.0,0.0,3.0,3320,0,1995,0,950000.0,Bellevue,98006,3320
4.0,3.0,2270,7375,1.0,0.0,0.0,4.0,1290,980,1973,0,498000.0,Kirkland,98034,2270
3.0,2.0,2910,17172,2.0,0.0,0.0,3.0,2910,0,1989,0,450000.0,FederalWay,98003,2910
5.0,2.0,2510,9887,2.0,0.0,0.0,3.0,2510,0,1972,2002,955000.0,MercerIsland,98040,2510
2.0,1.0,1240,7200,1.0,0.0,0.0,3.0,1240,0,1967,2011,215000.0,Tukwila,98168,1240
3.0,3.0,2580,5200,2.0,0.0,0.0,3.0,2580,0,2008,0,437000.0,Renton,98059,2580
3.0,3.0,2470,3600,2.0,0.0,0.0,3.0,2470,0,2007,0,773000.0,Issaquah,98029,2470
3.0,2.0,1690,5025,2.0,0.0,0.0,3.0,1690,0,2003,0,256883.0,FederalWay,98023,1690
4.0,2.0,2240,12032,1.0,0.0,0.0,3.0,2240,0,1983,2009,592500.0,Sammamish,98074,2240
3.0,2.0,1650,7352,1.0,0.0,0.0,3.0,1160,490,1979,2014,252350.0,Renton,98058,1650
4.0,2.0,2710,5880,2.0,0.0,0.0,3.0,2710,0,1998,2006,370000.0,Auburn,98092,2710
3.0,2.0,1260,10350,1.0,0.0,0.0,3.0,1260,0,1959,1989,465750.0,Bellevue,98008,1260
3.0,1.0,1150,8100,1.0,0.0,0.0,3.0,1150,0,1932,0,185000.0,Seattle,98168,1150
4.0,3.0,2550,7636,1.0,0.0,0.0,3.0,1440,1110,1986,0,582800.0,Sammamish,98074,2550
3.0,2.0,1490,6930,1.0,0.0,0.0,4.0,1490,0,1990,0,245000.0,Kent,98030,1490
4.0,2.0,2020,7865,1.0,0.0,0.0,4.0,1010,1010,1963,0,302000.0,Renton,98059,2020
2.0,1.0,1320,4520,1.0,0.0,1.0,3.0,1320,0,1912,1971,451555.0,Seattle,98116,1320
3.0,1.0,1230,10350,1.0,0.0,0.0,4.0,1230,0,1957,2001,250000.0,Renton,98055,1230
4.0,2.0,2070,7800,2.0,0.0,0.0,3.0,2070,0,1989,0,255000.0,FederalWay,98003,2070
4.0,2.0,2930,11562,1.0,0.0,3.0,3.0,1670,1260,1947,2012,840000.0,Seattle,98117,2930
3.0,1.0,1090,8520,1.0,0.0,0.0,3.0,1090,0,1967,2011,190000.0,FederalWay,98003,1090
3.0,1.0,1400,7066,1.0,0.0,0.0,3.0,1400,0,1957,2000,349950.0,Seattle,98125,1400
4.0,2.0,1550,4815,1.5,0.0,0.0,3.0,1550,0,1909,2004,613000.0,Seattle,98103,1550
3.0,1.0,1220,13000,1.0,0.0,0.0,4.0,1220,0,1955,2009,300000.0,Shoreline,98133,1220
3.0,2.0,1870,7344,1.0,0.0,0.0,3.0,1470,400,1980,0,455000.0,Kirkland,98034,1870
3.0,1.0,980,3090,1.5,0.0,0.0,3.0,980,0,1903,2005,197500.0,Seattle,98118,980
3.0,2.0,1490,8475,1.0,0.0,0.0,4.0,1490,0,1963,0,412500.0,Redmond,98052,1490
3.0,2.0,1120,7000,1.0,0.0,0.0,3.0,1120,0,1955,2005,395300.0,Bellevue,98007,1120
3.0,2.0,1180,9630,2.0,0.0,0.0,3.0,1180,0,1986,0,342400.0,Kenmore,98028,1180
4.0,2.0,2150,6807,2.0,0.0,0.0,4.0,2150,0,1991,0,316500.0,Kent,98031,2150
3.0,2.0,2240,10800,2.0,0.0,0.0,3.0,2240,0,1996,0,390000.0,Kenmore,98028,2240
3.0,2.0,1400,7384,1.0,0.0,0.0,3.0,1150,250,1979,2014,225000.0,Renton,98058,1400
2.0,1.0,1490,6000,1.0,0.0,0.0,3.0,1090,400,1946,0,575000.0,Seattle,98112,1490
5.0,4.0,3920,16258,2.0,0.0,0.0,3.0,2900,1020,1990,2009,1000000.0,Bellevue,98004,3920
5.0,2.0,2000,3750,2.0,0.0,0.0,4.0,2000,0,1921,0,585000.0,Seattle,98103,2000
4.0,2.0,2680,9185,2.0,0.0,0.0,3.0,2680,0,1989,0,620000.0,Issaquah,98029,2680
4.0,2.0,1670,9987,1.0,0.0,0.0,3.0,1670,0,1967,2011,204700.0,Auburn,98001,1670
4.0,3.0,3150,9130,2.0,0.0,0.0,3.0,3150,0,2001,0,695000.0,Sammamish,98075,3150
4.0,3.0,2740,7266,2.0,0.0,0.0,3.0,2060,680,2003,0,689900.0,Issaquah,98027,2740
4.0,2.0,1890,8000,1.0,0.0,0.0,4.0,1250,640,1960,2001,375000.0,Shoreline,98133,1890
3.0,1.0,1160,10384,1.0,0.0,0.0,4.0,1160,0,1969,0,215000.0,MapleValley,98038,1160
3.0,2.0,1790,6117,1.0,0.0,2.0,3.0,1350,440,1940,1996,790000.0,Seattle,98199,1790
3.0,2.0,4560,17622,2.0,0.0,0.0,4.0,3800,760,1986,0,695000.0,Sammamish,98074,4560
3.0,2.0,1590,7748,2.0,0.0,0.0,4.0,1590,0,1991,0,263000.0,FederalWay,98003,1590
3.0,1.0,1630,10304,1.0,0.0,0.0,5.0,1630,0,1953,0,400000.0,Shoreline,98155,1630
3.0,2.0,2700,7434,2.0,0.0,0.0,3.0,2700,0,1991,0,525000.0,Woodinville,98072,2700
3.0,2.0,1700,7496,2.0,0.0,0.0,3.0,1700,0,1994,0,349950.0,Renton,98055,1700
4.0,3.0,3740,12080,1.0,0.0,0.0,3.0,2000,1740,1988,2000,1085000.0,Woodinville,98077,3740
4.0,3.0,1980,5352,2.5,0.0,0.0,3.0,1980,0,1941,2005,744000.0,Seattle,98136,1980
2.0,1.0,880,6345,1.0,0.0,0.0,3.0,880,0,1919,2001,312500.0,Seattle,98106,880
3.0,2.0,1400,6200,1.0,0.0,0.0,3.0,700,700,1948,1994,240000.0,Shoreline,98133,1400
4.0,2.0,2050,4000,1.5,0.0,0.0,5.0,1210,840,1941,0,495000.0,Seattle,98144,2050
3.0,2.0,2360,4638,2.0,0.0,3.0,3.0,2360,0,1996,0,580050.0,Seattle,98115,2360
4.0,2.0,2560,7798,1.0,0.0,0.0,4.0,1890,670,1947,1988,640000.0,Seattle,98115,2560
3.0,2.0,1340,10224,1.0,0.0,0.0,4.0,1340,0,1956,0,417000.0,Bellevue,98006,1340
3.0,1.0,1060,5200,1.0,0.0,0.0,5.0,1060,0,1970,0,174950.0,Covington,98042,1060
3.0,2.0,850,2500,1.0,0.0,0.0,3.0,850,0,1986,0,295000.0,Seattle,98106,850
4.0,2.0,1880,7303,1.0,0.0,0.0,3.0,1010,870,1976,0,423000.0,Kirkland,98034,1880
3.0,1.0,1230,12305,1.0,0.0,0.0,3.0,1230,0,1955,1990,839000.0,Bellevue,98004,1230
4.0,2.0,2290,10290,1.0,0.0,0.0,3.0,1340,950,1960,2012,343000.0,Seattle,98146,2290
3.0,1.0,1660,6582,1.0,0.0,0.0,5.0,1000,660,1946,0,467000.0,Seattle,98133,1660
3.0,2.0,1840,2875,2.0,0.0,0.0,4.0,1840,0,1997,0,512500.0,Seattle,98116,1840
4.0,2.0,3020,17810,1.0,0.0,0.0,3.0,1600,1420,1979,2014,575000.0,LakeForestPark,98155,3020
3.0,2.0,1410,6886,1.0,0.0,0.0,3.0,1410,0,1924,2013,465000.0,Seattle,98133,1410
3.0,1.0,1010,9514,1.0,0.0,0.0,3.0,1010,0,1969,2010,270000.0,Renton,98059,1010
3.0,2.0,1960,8136,1.0,0.0,0.0,3.0,980,980,1948,1994,340000.0,Seattle,98106,1960
5.0,4.0,3580,14275,2.0,0.0,0.0,3.0,3190,390,1999,0,765000.0,Issaquah,98027,3580
4.0,2.0,2240,7200,2.0,0.0,0.0,3.0,2240,0,1995,0,497000.0,Seattle,98118,2240
3.0,2.0,1232,1130,3.0,0.0,0.0,3.0,1232,0,2007,0,344000.0,Seattle,98125,1232
3.0,2.0,1720,3600,2.0,0.0,0.0,3.0,1720,0,2010,0,386380.0,Redmond,98053,1720
3.0,2.0,1490,974,2.0,0.0,0.0,3.0,1220,270,2009,0,312000.0,Seattle,98106,1490
2.0,2.0,1070,9643,1.0,0.0,0.0,3.0,1070,0,1985,0,252700.0,Kent,98030,1070
1.0,1.0,700,5100,1.0,0.0,0.0,3.0,700,0,1942,1999,350000.0,Seattle,98115,700
3.0,2.0,2720,6439,2.0,0.0,0.0,3.0,2720,0,2005,0,619000.0,Snoqualmie,98065,2720
3.0,2.0,1800,5761,2.0,0.0,0.0,4.0,1800,0,1990,0,408200.0,Seattle,98106,1800
3.0,2.0,1560,4049,1.5,0.0,2.0,3.0,1000,560,1926,2003,451000.0,Seattle,98126,1560
3.0,2.0,1760,11410,1.0,0.0,0.0,5.0,1060,700,1977,0,317000.0,Renton,98058,1760
4.0,3.0,3120,5000,2.0,0.0,0.0,3.0,2370,750,2005,0,799000.0,Seattle,98115,3120
2.0,1.0,2020,7200,1.0,0.0,3.0,4.0,1700,320,1947,1988,720000.0,Seattle,98146,2020
4.0,2.0,1860,7000,1.0,0.0,0.0,3.0,1120,740,1979,2014,239900.0,FederalWay,98023,1860
4.0,2.0,2270,7800,1.0,0.0,0.0,3.0,1290,980,1977,2004,446000.0,Kirkland,98034,2270
3.0,2.0,1480,15639,2.0,0.0,0.0,3.0,1480,0,1987,2000,275000.0,NorthBend,98045,1480
5.0,1.0,1460,6032,2.0,0.0,0.0,4.0,1460,0,1941,1998,239950.0,Tukwila,98168,1460
4.0,4.0,1850,6519,2.0,0.0,0.0,3.0,1130,720,1986,0,248000.0,FederalWay,98023,1850
3.0,2.0,2170,5000,2.0,0.0,0.0,3.0,2170,0,2003,0,619500.0,Issaquah,98029,2170
3.0,2.0,1180,10541,1.0,0.0,0.0,4.0,940,240,1981,0,385000.0,Sammamish,98074,1180
4.0,2.0,1370,9957,1.0,0.0,0.0,3.0,900,470,1972,2002,370000.0,Kirkland,98034,1370
3.0,2.0,2670,13218,1.0,0.0,0.0,4.0,2670,0,1988,0,425000.0,Kent,98042,2670
3.0,1.0,1260,6826,1.0,0.0,0.0,3.0,720,540,1944,0,342000.0,Seattle,98125,1260
4.0,1.0,1980,7991,1.5,0.0,0.0,3.0,1980,0,1962,2003,345000.0,Renton,98058,1980
3.0,2.0,2050,3933,1.0,0.0,0.0,3.0,1180,870,1926,2001,724800.0,Seattle,98112,2050
5.0,3.0,2830,5310,2.0,0.0,0.0,3.0,2830,0,2006,0,725000.0,Redmond,98052,2830
2.0,1.0,910,3600,1.0,0.0,0.0,4.0,910,0,1909,1989,605000.0,Seattle,98119,910
4.0,2.0,2440,4000,2.0,0.0,0.0,3.0,2440,0,2009,0,350000.0,MapleValley,98038,2440
3.0,2.0,2180,5440,1.0,0.0,0.0,5.0,1100,1080,1904,0,785000.0,Seattle,98103,2180
3.0,2.0,1900,6660,1.0,0.0,0.0,5.0,950,950,1966,0,250000.0,MapleValley,98038,1900
3.0,2.0,2220,6641,1.0,0.0,2.0,4.0,1220,1000,1947,1988,875000.0,Seattle,98199,2220
2.0,1.0,830,6017,1.0,0.0,0.0,4.0,830,0,1954,1979,282613.0,Shoreline,98133,830
2.0,1.0,1010,5200,1.0,0.0,0.0,3.0,1010,0,1955,2005,174500.0,DesMoines,98198,1010
3.0,2.0,1990,7340,2.0,0.0,0.0,3.0,1990,0,1984,0,445000.0,Woodinville,98072,1990
4.0,2.0,2280,7568,2.0,0.0,0.0,4.0,2280,0,2001,0,433000.0,Renton,98056,2280
3.0,2.0,1870,5874,2.0,0.0,0.0,3.0,1870,0,2005,0,306000.0,Kent,98042,1870
3.0,2.0,1720,4000,1.5,0.0,0.0,4.0,1450,270,1921,0,620000.0,Seattle,98105,1720
2.0,1.0,870,6150,1.0,0.0,0.0,3.0,870,0,1941,1994,245000.0,Seattle,98106,870
3.0,2.0,1260,3135,1.5,0.0,0.0,3.0,1260,0,1931,0,523000.0,Seattle,98116,1260
3.0,2.0,2370,7875,2.0,0.0,0.0,3.0,2370,0,2003,0,522500.0,Snoqualmie,98065,2370
3.0,1.0,1000,18513,1.0,0.0,0.0,3.0,1000,0,1940,1996,180000.0,Seattle,98146,1000
3.0,2.0,1100,1751,2.0,0.0,0.0,3.0,940,160,2007,0,375000.0,Seattle,98144,1100
3.0,2.0,1440,7673,1.0,0.0,0.0,3.0,940,500,1982,0,249000.0,Kent,98031,1440
4.0,2.0,3120,14300,2.0,0.0,0.0,3.0,3120,0,2003,0,730100.0,Issaquah,98027,3120
2.0,2.0,2260,9604,1.0,0.0,0.0,3.0,2260,0,1990,2009,551000.0,Bothell,98011,2260
4.0,2.0,2790,7956,2.0,0.0,0.0,3.0,2790,0,2005,0,375000.0,DesMoines,98198,2790
1.0,1.0,1140,6700,1.5,0.0,0.0,3.0,1140,0,1920,1979,540000.0,Seattle,98103,1140
3.0,2.0,1290,2500,2.0,0.0,0.0,4.0,1290,0,1987,0,605000.0,Seattle,98112,1290
5.0,2.0,1730,5200,1.0,0.0,0.0,4.0,1050,680,1978,2000,205000.0,Covington,98042,1730
4.0,2.0,3160,11380,2.0,0.0,0.0,3.0,3160,0,1983,2009,645000.0,Sammamish,98074,3160
4.0,2.0,2340,8990,2.0,0.0,0.0,3.0,2340,0,2003,0,314000.0,MapleValley,98038,2340
3.0,2.0,1170,4950,1.0,0.0,0.0,4.0,1170,0,1960,2001,330000.0,Bellevue,98007,1170
2.0,1.0,1160,5000,1.0,0.0,0.0,4.0,1160,0,1937,0,490000.0,Seattle,98117,1160
3.0,2.0,1410,1377,2.0,0.0,0.0,3.0,1290,120,2005,0,377500.0,Issaquah,98027,1410
4.0,2.0,2430,5000,2.0,0.0,0.0,3.0,2430,0,2009,0,480000.0,Snoqualmie,98065,2430
5.0,2.0,3360,5402,2.0,0.0,0.0,3.0,3360,0,2014,0,804995.0,Sammamish,98074,3360
5.0,2.0,3200,6455,2.0,0.0,0.0,3.0,3200,0,2009,0,675000.0,Snoqualmie,98065,3200
3.0,2.0,2134,1984,2.5,0.0,0.0,3.0,2134,0,2008,0,611000.0,Issaquah,98029,2134
3.0,3.0,1860,1787,3.0,0.0,0.0,3.0,1860,0,2007,0,379950.0,Shoreline,98155,1860
2.0,2.0,1310,1500,2.0,0.0,0.0,3.0,1160,150,2006,0,500000.0,Seattle,98122,1310
3.0,2.0,1700,4250,1.0,0.0,0.0,3.0,890,810,1944,0,410000.0,Seattle,98199,1700
3.0,2.0,2480,8342,2.0,0.0,0.0,3.0,2480,0,1986,0,415000.0,Renton,98058,2480
5.0,2.0,1970,8605,2.0,0.0,0.0,4.0,1970,0,1994,0,297000.0,Enumclaw,98022,1970
4.0,2.0,2060,7475,1.0,0.0,0.0,3.0,1440,620,1985,0,575550.0,Redmond,98052,2060
3.0,2.0,2130,3500,1.0,0.0,0.0,4.0,1210,920,1994,0,534640.0,Woodinville,98072,2130
3.0,2.0,1410,14110,1.0,0.0,2.0,3.0,1170,240,1987,2000,352500.0,Snoqualmie,98065,1410
2.0,2.0,1360,4688,1.0,0.0,0.0,3.0,780,580,1944,0,488000.0,Seattle,98115,1360
2.0,2.0,1610,2040,2.0,0.0,0.0,4.0,1610,0,1979,0,215000.0,Renton,98056,1610
2.0,2.0,1420,9191,1.5,0.0,2.0,5.0,1420,0,1928,1970,592500.0,Seattle,98115,1420
4.0,2.0,1700,7280,2.0,0.0,0.0,4.0,1700,0,1988,0,290000.0,Kent,98031,1700
2.0,1.0,1490,3825,1.0,0.0,0.0,3.0,860,630,1929,0,475000.0,Seattle,98117,1490
3.0,2.0,2680,7757,2.0,0.0,0.0,3.0,2680,0,1990,2009,320000.0,FederalWay,98023,2680
5.0,2.0,2120,7700,1.5,0.0,0.0,5.0,2120,0,1962,0,290000.0,Renton,98058,2120
4.0,2.0,1690,3250,1.5,0.0,0.0,3.0,1550,140,1901,0,487250.0,Seattle,98103,1690
4.0,2.0,1830,8601,2.0,0.0,0.0,3.0,1830,0,2003,0,339000.0,MapleValley,98038,1830
2.0,2.0,1010,1968,1.5,0.0,0.0,5.0,1010,0,1906,0,440000.0,Seattle,98107,1010
4.0,3.0,2070,9300,1.0,0.0,0.0,5.0,1120,950,1945,0,366500.0,Shoreline,98155,2070
3.0,2.0,1710,4500,1.5,0.0,0.0,3.0,1410,300,1928,1954,462000.0,Seattle,98118,1710
4.0,1.0,1660,4690,1.5,0.0,0.0,3.0,1260,400,1945,2010,560000.0,Seattle,98117,1660
4.0,2.0,2080,13629,1.0,0.0,0.0,4.0,1040,1040,1955,2009,285000.0,Seattle,98178,2080
3.0,2.0,1270,9675,2.0,0.0,0.0,3.0,1270,0,1993,0,280000.0,NorthBend,98045,1270
3.0,2.0,1610,5100,1.5,0.0,0.0,5.0,1610,0,1940,0,690000.0,Seattle,98115,1610
2.0,1.0,1120,9912,1.0,0.0,0.0,4.0,1120,0,1980,0,256500.0,Vashon,98070,1120
3.0,1.0,970,7275,1.0,0.0,0.0,4.0,970,0,1970,0,215000.0,Kent,98031,970
5.0,2.0,3370,5000,1.5,0.0,0.0,4.0,2140,1230,1907,0,762000.0,Seattle,98109,3370
4.0,2.0,2490,8290,2.0,0.0,0.0,3.0,2490,0,1999,0,390000.0,Auburn,98092,2490
2.0,1.0,770,4000,1.0,0.0,0.0,5.0,770,0,1924,1956,413500.0,Seattle,98117,770
1.0,2.0,810,3211,2.0,0.0,0.0,4.0,810,0,1982,2011,285000.0,Kirkland,98033,810
4.0,2.0,3060,10043,1.0,0.0,0.0,4.0,1700,1360,1968,0,475000.0,Shoreline,98133,3060
3.0,2.0,1690,1613,2.0,0.0,0.0,3.0,1150,540,2014,0,386591.0,Issaquah,98029,1690
3.0,2.0,1890,3825,1.0,0.0,0.0,3.0,1290,600,1974,0,524950.0,Seattle,98117,1890
2.0,2.0,1470,3128,2.0,0.0,0.0,3.0,1470,0,2005,0,241000.0,MapleValley,98038,1470
2.0,1.0,1060,7193,1.0,0.0,0.0,3.0,1060,0,1926,2003,461000.0,Seattle,98133,1060
4.0,3.0,2730,3560,1.5,0.0,0.0,3.0,1550,1180,1921,2007,885000.0,Seattle,98115,2730
3.0,2.0,1580,7941,2.0,0.0,0.0,4.0,1580,0,1986,0,247000.0,FederalWay,98023,1580
3.0,3.0,2170,7900,1.0,0.0,0.0,4.0,1380,790,1978,2000,296500.0,Kent,98032,2170
2.0,1.0,930,4743,1.0,0.0,0.0,4.0,930,0,1942,1982,141800.0,Renton,98056,930
4.0,2.0,1580,7800,2.0,0.0,0.0,2.0,1580,0,1906,0,333000.0,Seattle,98144,1580
5.0,2.0,3290,11900,1.5,0.0,0.0,3.0,3290,0,1973,2013,602000.0,Redmond,98052,3290
4.0,2.0,2110,10698,2.0,0.0,0.0,4.0,2110,0,1979,0,565000.0,Issaquah,98027,2110
3.0,2.0,1670,3565,2.0,0.0,0.0,3.0,1670,0,1999,0,373000.0,Woodinville,98072,1670
3.0,2.0,2030,7350,1.0,0.0,0.0,4.0,1190,840,1977,0,588000.0,Redmond,98052,2030
3.0,1.0,1500,4100,1.5,0.0,0.0,3.0,1370,130,1926,2003,485000.0,Seattle,98107,1500
3.0,2.0,1450,1445,2.0,0.0,0.0,3.0,980,470,2005,0,482500.0,Seattle,98122,1450
4.0,2.0,1310,8250,1.0,0.0,0.0,3.0,1060,250,1953,0,251200.0,DesMoines,98148,1310
4.0,2.0,2660,10452,2.0,0.0,0.0,3.0,2660,0,1993,0,755000.0,Redmond,98052,2660
3.0,2.0,1720,1916,2.0,0.0,0.0,3.0,1720,0,2005,0,280000.0,Renton,98056,1720
3.0,2.0,1610,12247,1.0,0.0,0.0,3.0,1610,0,1981,2013,305000.0,Renton,98058,1610
2.0,1.0,680,8064,1.0,0.0,0.0,3.0,680,0,1941,1994,110700.0,SeaTac,98188,680
4.0,4.0,2640,5900,2.0,0.0,2.0,3.0,2640,0,1937,1998,850000.0,Seattle,98136,2640
3.0,2.0,1640,7200,2.0,0.0,0.0,4.0,1640,0,1985,0,350000.0,Bellevue,98007,1640
4.0,2.0,2310,8045,1.0,0.0,0.0,4.0,1650,660,1976,1992,319950.0,Renton,98058,2310
3.0,2.0,2010,4905,1.0,0.0,0.0,5.0,1230,780,1912,0,700000.0,Seattle,98122,2010
2.0,2.0,1660,4680,1.0,0.0,0.0,5.0,830,830,1908,0,368000.0,Seattle,98146,1660
3.0,2.0,2200,3360,2.0,0.0,0.0,3.0,2200,0,2009,0,433500.0,Seattle,98118,2200
4.0,2.0,2460,4200,2.0,0.0,0.0,3.0,2460,0,1998,2006,611000.0,Redmond,98074,2460
3.0,1.0,1370,7500,1.0,0.0,0.0,3.0,1370,0,1960,2012,307000.0,Carnation,98014,1370
3.0,2.0,1800,10200,1.0,0.0,0.0,3.0,1800,0,1967,2011,442500.0,Renton,98058,1800
3.0,2.0,2200,7706,2.0,0.0,2.0,3.0,2200,0,1908,1988,485000.0,DesMoines,98198,2200
2.0,1.0,700,2334,1.0,0.0,0.0,3.0,700,0,1945,2010,367000.0,Seattle,98117,700
3.0,2.0,1920,15124,2.0,0.0,0.0,3.0,1920,0,1995,0,429000.0,NorthBend,98045,1920
5.0,3.0,2190,12687,1.0,0.0,0.0,5.0,1370,820,1978,0,446000.0,Kenmore,98028,2190
3.0,2.0,2030,9791,1.0,0.0,0.0,4.0,1500,530,1984,0,572500.0,Newcastle,98059,2030
3.0,2.0,1350,2053,3.0,0.0,0.0,3.0,1350,0,2005,0,477000.0,Seattle,98117,1350
3.0,2.0,1680,2096,2.0,0.0,0.0,3.0,1380,300,2008,0,518000.0,Seattle,98117,1680
5.0,2.0,1250,10530,1.0,0.0,0.0,4.0,1250,0,1966,0,462000.0,Bellevue,98007,1250
3.0,1.0,950,7620,1.0,0.0,0.0,3.0,950,0,1954,2005,137000.0,Seattle,98106,950
3.0,4.0,2320,3174,2.0,0.0,0.0,3.0,2060,260,1997,0,530000.0,Kirkland,98033,2320
2.0,2.0,2380,9374,1.0,0.0,2.0,3.0,2380,0,2011,0,818000.0,Redmond,98053,2380
2.0,2.0,1540,958,3.0,0.0,0.0,3.0,1540,0,2007,0,640000.0,Seattle,98122,1540
5.0,3.0,2100,9752,1.0,0.0,0.0,3.0,1200,900,2007,0,298450.0,FederalWay,98003,2100
3.0,2.0,2830,5802,2.0,0.0,0.0,3.0,2830,0,2001,0,551000.0,Kenmore,98028,2830
2.0,1.0,870,5340,1.5,0.0,0.0,2.0,870,0,1906,0,271310.0,Seattle,98144,870
3.0,2.0,1260,889,3.0,0.0,0.0,3.0,1260,0,2008,0,479000.0,Seattle,98109,1260
4.0,4.0,2680,10000,2.0,0.0,0.0,3.0,2040,640,1942,2014,520000.0,Seattle,98125,2680
3.0,2.0,2660,4975,2.0,0.0,0.0,3.0,2660,0,2014,0,599950.0,Seattle,98118,2660
2.0,2.0,1480,5120,1.0,0.0,0.0,4.0,840,640,1951,1999,483945.0,Seattle,98116,1480
2.0,1.0,950,7692,1.0,0.0,0.0,3.0,950,0,1926,2003,192500.0,Seattle,98168,950
2.0,1.0,860,8308,1.0,0.0,0.0,4.0,860,0,1948,0,330000.0,Seattle,98146,860
4.0,2.0,1960,7560,1.0,0.0,0.0,5.0,1160,800,1978,0,250000.0,Kent,98031,1960
2.0,1.0,1770,5522,1.5,0.0,0.0,4.0,960,810,1943,0,243000.0,Seattle,98178,1770
4.0,2.0,1280,6060,1.0,0.0,0.0,3.0,860,420,1926,2003,575000.0,Seattle,98117,1280
4.0,2.0,2150,12028,2.0,0.0,0.0,4.0,2150,0,1982,2011,639000.0,Redmond,98052,2150
2.0,1.0,1790,4000,1.0,0.0,0.0,4.0,1040,750,1923,0,710000.0,Seattle,98112,1790
3.0,2.0,1990,10260,2.0,0.0,0.0,4.0,1990,0,1987,0,675000.0,Redmond,98052,1990
5.0,2.0,2430,4781,2.0,0.0,0.0,3.0,2430,0,2001,0,405000.0,Renton,98058,2430
4.0,3.0,2820,13193,1.0,0.0,0.0,3.0,1860,960,1965,1993,615000.0,Bellevue,98006,2820
3.0,1.0,1910,8190,1.0,0.0,0.0,4.0,1010,900,1946,1989,490000.0,Seattle,98117,1910
3.0,2.0,1270,1213,2.0,0.0,0.0,3.0,1040,230,2005,0,467000.0,Seattle,98107,1270
4.0,3.0,2050,3960,1.0,0.0,0.0,4.0,1180,870,1986,0,480000.0,Seattle,98116,2050
6.0,2.0,2150,4505,1.0,0.0,0.0,3.0,1270,880,1952,2008,755000.0,Seattle,98119,2150
4.0,2.0,2450,13300,1.0,0.0,2.0,4.0,1630,820,1987,0,760000.0,Bellevue,98006,2450
3.0,2.0,1570,7775,2.0,0.0,0.0,3.0,1570,0,1982,0,263000.0,Kent,98031,1570
4.0,2.0,1820,9350,1.0,0.0,0.0,4.0,1820,0,1967,0,519900.0,Redmond,98052,1820
2.0,2.0,1540,4025,1.0,0.0,0.0,4.0,1190,350,1908,0,570000.0,Seattle,98116,1540
3.0,1.0,1090,9900,1.0,0.0,0.0,4.0,1090,0,1955,2009,300000.0,Redmond,98052,1090
3.0,2.0,1480,7225,1.0,0.0,0.0,4.0,1480,0,1965,0,320000.0,Renton,98056,1480
4.0,1.0,1320,4440,1.5,0.0,0.0,3.0,1320,0,1929,0,387500.0,Seattle,98122,1320
1.0,2.0,2140,10350,1.0,0.0,0.0,3.0,1470,670,1976,0,458000.0,Woodinville,98072,2140
4.0,3.0,2800,9764,2.0,0.0,0.0,3.0,2800,0,2002,0,380000.0,MapleValley,98038,2800
3.0,1.0,1050,5000,1.0,0.0,0.0,4.0,1050,0,1967,0,200000.0,Renton,98056,1050
3.0,2.0,1490,9630,1.0,0.0,0.0,4.0,1490,0,1959,0,385000.0,Kenmore,98028,1490
2.0,1.0,1730,6375,2.0,0.0,0.0,4.0,1730,0,1945,0,396675.0,Seattle,98126,1730
3.0,2.0,1570,1050,2.0,0.0,0.0,3.0,1570,0,1915,0,792000.0,Seattle,98109,1570
6.0,3.0,1880,7200,1.0,0.0,0.0,4.0,1880,0,1966,0,326000.0,Renton,98056,1880
2.0,1.0,790,8424,1.0,0.0,0.0,4.0,790,0,1953,1983,268500.0,Shoreline,98133,790
2.0,2.0,1300,4000,2.0,0.0,0.0,3.0,1300,0,1948,1994,440000.0,Seattle,98105,1300
3.0,1.0,2120,7735,1.0,0.0,0.0,4.0,1060,1060,1967,0,300000.0,Renton,98059,2120
3.0,2.0,1540,4773,2.0,0.0,0.0,3.0,1540,0,1941,2009,525000.0,Seattle,98126,1540
4.0,3.0,2620,13777,1.5,0.0,2.0,4.0,1720,900,1926,1993,978000.0,Seattle,98144,2620
6.0,3.0,2880,3192,2.0,0.0,0.0,4.0,2180,700,1919,1985,1125000.0,Seattle,98103,2880
4.0,1.0,1680,4021,1.5,0.0,0.0,3.0,1680,0,1921,2000,700000.0,Seattle,98103,1680
2.0,1.0,790,6969,1.0,0.0,0.0,3.0,790,0,1955,1984,315000.0,Redmond,98052,790
3.0,1.0,1092,7500,1.5,0.0,0.0,3.0,1092,0,1918,0,309000.0,Seattle,98106,1092
3.0,2.0,1650,9936,1.0,0.0,0.0,3.0,1090,560,1967,2011,219950.0,FederalWay,98003,1650
3.0,2.0,2090,4700,2.0,0.0,0.0,3.0,2090,0,2002,0,289000.0,Covington,98042,2090
4.0,2.0,1990,6671,2.0,0.0,0.0,3.0,1990,0,1989,0,260000.0,FederalWay,98023,1990
4.0,2.0,2650,7945,2.0,0.0,0.0,3.0,2650,0,2006,0,699000.0,Seattle,98125,2650
3.0,1.0,910,8000,1.0,0.0,0.0,4.0,740,170,1950,1983,299950.0,Shoreline,98177,910
3.0,2.0,2770,10773,2.0,0.0,2.0,3.0,2770,0,1992,0,749950.0,Bellevue,98008,2770
3.0,2.0,2390,6888,2.0,0.0,1.0,5.0,2390,0,1939,0,1100000.0,Seattle,98115,2390
3.0,2.0,1700,4000,2.0,0.0,0.0,3.0,1700,0,2003,0,384000.0,Snoqualmie,98065,1700
3.0,2.0,1200,4500,1.0,0.0,0.0,5.0,1200,0,1906,0,430000.0,Seattle,98108,1200
4.0,2.0,2220,6953,2.0,0.0,0.0,4.0,2220,0,1999,0,350000.0,MapleValley,98038,2220
4.0,2.0,2560,12100,1.0,0.0,0.0,4.0,1760,800,1976,1992,765000.0,Redmond,98052,2560
4.0,2.0,2500,6300,1.0,0.0,0.0,4.0,1500,1000,1961,2001,250000.0,Kent,98032,2500
2.0,1.0,1150,4000,1.0,0.0,0.0,3.0,1150,0,1947,2012,376000.0,Seattle,98199,1150
4.0,2.0,1650,7775,1.0,0.0,0.0,4.0,1150,500,1950,1983,475000.0,Seattle,98133,1650
3.0,2.0,1140,9628,1.0,0.0,0.0,4.0,1140,0,1969,0,120750.0,FederalWay,98023,1140
3.0,2.0,1700,4105,2.0,0.0,0.0,3.0,1700,0,1992,0,619500.0,Seattle,98122,1700
3.0,2.0,1240,11200,1.0,0.0,0.0,4.0,1240,0,1954,1979,345000.0,Bellevue,98006,1240
5.0,2.0,2890,12478,2.0,0.0,0.0,3.0,2890,0,1977,2004,598000.0,Sammamish,98074,2890
3.0,1.0,1060,10050,1.0,0.0,0.0,4.0,1060,0,1967,0,335000.0,Kenmore,98028,1060
4.0,2.0,1590,10523,2.0,0.0,0.0,4.0,1590,0,1922,0,372500.0,Shoreline,98133,1590
6.0,5.0,2860,5682,2.0,0.0,0.0,3.0,2860,0,1978,0,300000.0,Auburn,98002,2860
1.0,1.0,820,1060,1.0,0.0,0.0,3.0,760,60,2007,0,194000.0,Seattle,98126,820
3.0,2.0,2020,8118,1.0,0.0,0.0,3.0,1020,1000,1963,2008,507500.0,Bellevue,98008,2020
4.0,2.0,1870,9680,1.0,0.0,0.0,4.0,1170,700,1959,0,325000.0,Kirkland,98034,1870
4.0,2.0,1600,6765,1.0,0.0,0.0,3.0,830,770,1947,2011,329000.0,Seattle,98106,1600
4.0,2.0,2090,4300,1.5,0.0,0.0,4.0,1250,840,1925,1968,494000.0,Seattle,98136,2090
4.0,2.0,1700,6025,1.0,0.0,0.0,3.0,1700,0,1978,0,206000.0,Auburn,98002,1700
4.0,2.0,1940,6909,1.0,0.0,0.0,4.0,970,970,1941,1998,423000.0,Seattle,98133,1940
3.0,1.0,1320,8625,1.0,0.0,0.0,4.0,1320,0,1957,2001,259000.0,Renton,98056,1320
4.0,2.0,3500,13875,1.0,0.0,4.0,4.0,1830,1670,1938,0,879950.0,Seattle,98146,3500
5.0,4.0,2800,5120,2.5,0.0,0.0,3.0,2800,0,1903,2005,345600.0,Seattle,98122,2800
3.0,2.0,1080,2940,1.5,0.0,0.0,4.0,1080,0,1920,0,395000.0,Seattle,98115,1080
4.0,2.0,3550,8048,2.0,0.0,0.0,3.0,3550,0,2007,0,625000.0,Snoqualmie,98065,3550
3.0,2.0,1690,1468,2.0,0.0,0.0,3.0,1380,310,2008,0,380000.0,Seattle,98108,1690
3.0,2.0,1270,1443,3.0,0.0,0.0,3.0,1270,0,2007,0,440000.0,Seattle,98115,1270
3.0,2.0,1970,2377,2.0,0.0,0.0,3.0,1680,290,2008,0,415000.0,Seattle,98108,1970
4.0,3.0,3160,8097,2.0,0.0,0.0,3.0,3160,0,2014,0,860000.0,Kirkland,98033,3160
3.0,2.0,1210,1200,3.0,0.0,0.0,3.0,1210,0,2008,0,500000.0,Seattle,98103,1210
4.0,4.0,3120,5086,2.0,0.0,0.0,3.0,2480,640,2008,0,953007.0,Seattle,98115,3120
4.0,2.0,2670,8765,2.0,0.0,0.0,3.0,2670,0,2006,0,515000.0,Renton,98059,2670
3.0,2.0,1640,1204,3.0,0.0,0.0,3.0,1640,0,2014,0,772000.0,Seattle,98112,1640
3.0,2.0,1800,3168,2.0,0.0,0.0,3.0,1800,0,2014,0,409316.0,Snoqualmie,98065,1800
2.0,2.0,1590,2656,2.0,0.0,0.0,3.0,1220,370,2009,0,305000.0,Seattle,98106,1590
4.0,4.0,3070,4684,2.0,0.0,0.0,3.0,2190,880,2009,0,785000.0,Issaquah,98027,3070
2.0,2.0,1330,7200,1.0,0.0,0.0,3.0,1330,0,1993,0,240000.0,SeaTac,98188,1330
3.0,1.0,990,6750,1.0,0.0,0.0,4.0,990,0,1947,1988,325000.0,Seattle,98133,990
4.0,2.0,1900,5790,2.0,0.0,0.0,3.0,1900,0,1994,0,535800.0,Issaquah,98029,1900
3.0,2.0,2020,1159,3.0,0.0,3.0,3.0,2020,0,2000,0,720000.0,Seattle,98103,2020
3.0,2.0,2000,9416,1.0,0.0,0.0,4.0,2000,0,1961,2001,374000.0,Kirkland,98033,2000
2.0,2.0,1100,7600,1.0,0.0,0.0,3.0,1100,0,1980,0,189650.0,DesMoines,98198,1100
4.0,3.0,3488,9614,2.0,0.0,0.0,3.0,3488,0,1998,2006,815000.0,Redmond,98074,3488
2.0,2.0,1890,9466,2.0,0.0,0.0,3.0,1890,0,1987,2000,1065000.0,Bellevue,98004,1890
4.0,2.0,2030,8120,2.0,0.0,0.0,3.0,2030,0,1950,2005,199000.0,Seattle,98178,2030
3.0,2.0,1380,7350,1.0,0.0,0.0,3.0,990,390,1981,2013,195000.0,Covington,98042,1380
3.0,2.0,1870,3230,2.0,0.0,0.0,3.0,1870,0,1997,0,288400.0,Renton,98056,1870
4.0,2.0,2080,12007,1.0,0.0,0.0,4.0,1220,860,1979,0,442000.0,Sammamish,98074,2080
4.0,3.0,2450,14803,2.0,0.0,0.0,4.0,2450,0,1988,0,619420.0,Newcastle,98059,2450
4.0,2.0,2750,6180,1.0,0.0,0.0,4.0,1500,1250,1948,0,635000.0,Seattle,98118,2750
3.0,1.0,1240,4842,1.0,0.0,0.0,4.0,1240,0,1916,0,210000.0,Seattle,98118,1240
3.0,2.0,1900,7604,2.0,0.0,0.0,3.0,1900,0,1990,2009,512500.0,Kirkland,98033,1900
3.0,2.0,2540,6093,2.0,0.0,0.0,3.0,2540,0,1999,0,567000.0,Kirkland,98034,2540
3.0,3.0,2100,10362,2.0,0.0,0.0,3.0,1510,590,1998,2006,525000.0,SnoqualmiePass,98068,2100
4.0,2.0,1790,2250,1.0,0.0,2.0,4.0,840,950,1909,1989,475000.0,Seattle,98103,1790
3.0,2.0,1170,7258,1.0,0.0,0.0,3.0,1170,0,1984,0,250000.0,Auburn,98001,1170
3.0,1.0,1060,9126,1.0,0.0,2.0,5.0,1060,0,1956,0,220000.0,Enumclaw,98022,1060
5.0,2.0,1930,6120,1.5,0.0,0.0,3.0,1930,0,1941,1969,230000.0,Seattle,98146,1930
3.0,2.0,1540,7947,1.0,0.0,0.0,3.0,1120,420,1961,2004,385500.0,Bothell,98011,1540
5.0,3.0,2876,13927,1.0,0.0,2.0,4.0,1970,906,1973,0,895000.0,MercerIsland,98040,2876
3.0,2.0,2150,7484,2.0,0.0,0.0,3.0,2150,0,1988,2000,368250.0,Sammamish,98074,2150
2.0,1.0,1140,5500,1.0,0.0,0.0,3.0,1140,0,1947,2012,249900.0,Seattle,98106,1140
3.0,2.0,980,7790,1.0,0.0,0.0,5.0,980,0,1969,0,350000.0,Kirkland,98034,980
3.0,2.0,1230,13056,1.0,0.0,0.0,4.0,1230,0,1962,0,175000.0,Auburn,98001,1230
3.0,2.0,1390,10905,1.0,0.0,0.0,3.0,860,530,1957,2000,270000.0,Seattle,98106,1390
3.0,4.0,2380,6250,2.0,0.0,3.0,3.0,1670,710,1997,0,495000.0,Seattle,98118,2380
3.0,1.0,1250,9126,1.0,0.0,0.0,3.0,1250,0,1969,2010,330000.0,Woodinville,98077,1250
4.0,3.0,2290,6120,2.0,0.0,0.0,4.0,2170,120,1926,1993,1003000.0,Seattle,98115,2290
2.0,1.0,790,5240,1.0,0.0,0.0,4.0,790,0,1925,1968,299800.0,Seattle,98118,790
3.0,2.0,2720,6014,2.0,0.0,0.0,3.0,2720,0,2002,0,299900.0,Auburn,98092,2720
4.0,3.0,2550,8632,1.0,0.0,0.0,3.0,1700,850,1972,2002,691000.0,Kirkland,98033,2550
2.0,1.0,1080,3899,1.0,0.0,0.0,4.0,1080,0,1972,0,195000.0,DesMoines,98198,1080
3.0,2.0,2470,9620,1.0,0.0,1.0,4.0,1570,900,1962,0,405000.0,DesMoines,98198,2470
2.0,1.0,850,7710,1.0,0.0,2.0,5.0,550,300,1909,1988,360000.0,Seattle,98108,850
3.0,2.0,1990,8991,1.0,0.0,0.0,3.0,1570,420,1969,2010,256750.0,Kent,98042,1990
3.0,2.0,1800,10500,2.0,0.0,0.0,3.0,1800,0,1995,0,332500.0,MapleValley,98038,1800
3.0,1.0,1020,7874,1.0,0.0,0.0,3.0,1020,0,1956,2001,218000.0,Seattle,98106,1020
4.0,2.0,2910,5776,2.0,0.0,2.0,3.0,2910,0,1998,2006,589000.0,Snoqualmie,98065,2910
3.0,2.0,1060,9039,1.0,0.0,0.0,3.0,1060,0,1973,2013,255000.0,Renton,98058,1060
4.0,2.0,2340,6420,1.0,0.0,2.0,3.0,1590,750,1964,2000,668750.0,Shoreline,98177,2340
4.0,3.0,1800,5453,1.0,0.0,0.0,3.0,1050,750,2002,0,344500.0,Renton,98055,1800
4.0,2.0,1660,6150,1.0,0.0,0.0,3.0,850,810,1945,2010,452000.0,Seattle,98126,1660
2.0,1.0,1030,4841,1.0,0.0,0.0,3.0,920,110,1939,1969,535000.0,Seattle,98103,1030
4.0,3.0,2790,5420,1.0,0.0,3.0,3.0,1130,1660,1963,2013,970000.0,Shoreline,98177,2790
3.0,1.0,1150,3000,1.0,0.0,0.0,5.0,1150,0,1906,0,430000.0,Seattle,98103,1150
4.0,2.0,3290,11446,2.0,0.0,0.0,3.0,3290,0,1992,0,520000.0,Kenmore,98028,3290
2.0,1.0,1200,4000,1.0,0.0,0.0,3.0,1070,130,1940,1996,450000.0,Seattle,98126,1200
4.0,2.0,2160,8005,2.0,0.0,0.0,3.0,2160,0,1993,0,220000.0,Pacific,98047,2160
3.0,1.0,1450,4000,1.0,0.0,1.0,4.0,950,500,1948,0,525000.0,Seattle,98118,1450
3.0,2.0,1470,1691,2.0,0.0,0.0,3.0,1000,470,2007,0,540000.0,Seattle,98115,1470
4.0,2.0,2360,5226,2.0,0.0,0.0,3.0,2360,0,2001,0,600000.0,Kirkland,98034,2360
3.0,2.0,2230,9053,2.0,0.0,0.0,4.0,2230,0,1987,0,600000.0,Bellevue,98007,2230
3.0,2.0,1445,1471,2.0,0.0,0.0,3.0,1300,145,2003,0,389999.0,Issaquah,98027,1445
3.0,2.0,2380,6000,1.5,0.0,0.0,3.0,1320,1060,1935,1974,285000.0,Seattle,98178,2380
4.0,3.0,2830,13059,2.0,0.0,0.0,3.0,2830,0,1998,2006,744000.0,Sammamish,98075,2830
4.0,2.0,2000,9000,1.0,0.0,0.0,4.0,2000,0,1978,2000,318989.0,FederalWay,98023,2000
3.0,2.0,2020,3600,2.0,0.0,0.0,3.0,2020,0,1998,2006,556000.0,Kirkland,98033,2020
3.0,2.0,2030,6326,2.0,0.0,0.0,3.0,2030,0,1993,0,275000.0,MapleValley,98038,2030
3.0,3.0,2550,11160,2.0,0.0,0.0,3.0,2550,0,1994,0,430000.0,Shoreline,98155,2550
2.0,1.0,970,13700,1.0,0.0,0.0,3.0,970,0,1949,1998,300000.0,Seattle,98106,970
3.0,2.0,1540,12446,1.0,0.0,0.0,5.0,1540,0,1967,0,396450.0,Issaquah,98027,1540
4.0,3.0,2780,7875,2.0,0.0,0.0,3.0,2780,0,2006,0,700000.0,Seattle,98133,2780
6.0,2.0,2220,8797,1.0,0.0,0.0,3.0,2220,0,1977,2004,260000.0,Auburn,98002,2220
4.0,4.0,2350,13402,2.0,0.0,3.0,3.0,1670,680,1994,0,655000.0,Kirkland,98033,2350
3.0,2.0,1440,4421,1.0,0.0,0.0,3.0,1440,0,2007,0,413800.0,Redmond,98053,1440
5.0,4.0,5330,6000,2.0,0.0,2.0,3.0,3570,1760,2006,0,950000.0,Issaquah,98027,5330
4.0,2.0,2220,4228,2.0,0.0,0.0,3.0,2220,0,2014,0,334990.0,Seattle,98146,2220
3.0,4.0,3880,13095,2.0,0.0,3.0,3.0,3700,180,2009,0,1030000.0,Kirkland,98034,3880
4.0,3.0,3810,8519,1.0,0.0,1.0,3.0,2680,1130,2007,0,1130000.0,Kirkland,98033,3810
3.0,3.0,1960,1168,2.0,0.0,0.0,3.0,1600,360,2007,0,556000.0,Issaquah,98029,1960
3.0,2.0,1530,1131,3.0,0.0,0.0,3.0,1530,0,2009,0,360000.0,Seattle,98103,1530
3.0,2.0,1750,7208,2.0,0.0,0.0,3.0,1750,0,1994,0,324000.0,Renton,98055,1750
1.0,1.0,1170,14149,1.0,0.0,0.0,5.0,880,290,1962,0,275000.0,Enumclaw,98022,1170
3.0,1.0,870,5330,1.0,0.0,0.0,3.0,870,0,1969,2014,180000.0,Covington,98042,870
4.0,2.0,2930,18199,2.0,0.0,0.0,3.0,2930,0,1998,2006,749000.0,Sammamish,98075,2930
2.0,1.0,800,3330,1.0,0.0,0.0,3.0,800,0,1918,0,373500.0,Seattle,98107,800
4.0,2.0,2350,8001,2.0,0.0,0.0,4.0,2350,0,1987,0,770000.0,Bellevue,98006,2350
2.0,2.0,1060,16470,1.0,0.0,0.0,3.0,1060,0,1977,2004,356000.0,Woodinville,98072,1060
3.0,2.0,2060,12558,1.0,0.0,0.0,4.0,1350,710,1984,0,625000.0,Redmond,98052,2060
2.0,2.0,1560,1750,1.0,0.0,0.0,4.0,780,780,1904,0,494400.0,Seattle,98109,1560
3.0,2.0,1660,4800,2.0,0.0,0.0,3.0,1660,0,1907,1983,926300.0,Seattle,98119,1660
3.0,2.0,1650,5100,1.0,0.0,0.0,5.0,1040,610,1908,0,600000.0,Seattle,98115,1650
4.0,3.0,3220,8936,2.0,0.0,0.0,3.0,2450,770,1990,2009,430000.0,Kent,98031,3220
3.0,2.0,2320,7500,1.0,0.0,0.0,3.0,2320,0,1976,0,307000.0,Duvall,98019,2320
4.0,3.0,2750,14982,1.0,0.0,3.0,3.0,1720,1030,1981,2013,604700.0,DesMoines,98198,2750
3.0,1.0,910,6000,1.0,0.0,0.0,2.0,910,0,1956,0,219900.0,Seattle,98146,910
2.0,2.0,840,867,2.0,0.0,0.0,3.0,840,0,2005,0,270000.0,Seattle,98115,840
3.0,2.0,1470,1578,2.0,0.0,0.0,3.0,1090,380,2007,0,432000.0,Seattle,98136,1470
6.0,2.0,2040,10812,1.0,0.0,0.0,4.0,2040,0,1943,0,300000.0,Renton,98056,2040
3.0,1.0,1100,4046,1.5,0.0,4.0,4.0,1100,0,1922,0,361000.0,DesMoines,98198,1100
2.0,1.0,940,8532,1.0,0.0,0.0,4.0,940,0,1959,0,249950.0,Burien,98166,940
3.0,2.0,1110,10500,1.0,0.0,0.0,5.0,1110,0,1978,0,320000.0,NorthBend,98045,1110
4.0,2.0,2200,8100,1.5,0.0,0.0,5.0,1400,800,1942,0,305000.0,Seattle,98168,2200
2.0,1.0,740,11250,1.0,0.0,0.0,2.0,740,0,1938,0,235750.0,Seattle,98146,740
4.0,2.0,2740,8520,1.0,0.0,2.0,3.0,1370,1370,1954,2005,657000.0,Seattle,98118,2740
3.0,1.0,1250,7300,1.0,0.0,0.0,4.0,1250,0,1956,0,385000.0,Bellevue,98008,1250
4.0,2.0,3140,8060,2.0,0.0,0.0,3.0,3140,0,1991,0,389950.0,FederalWay,98023,3140
2.0,1.0,820,10270,1.0,0.0,0.0,3.0,820,0,1954,2005,150000.0,Seattle,98168,820
4.0,3.0,2570,7264,2.0,0.0,0.0,3.0,1720,850,1998,2006,254500.0,Auburn,98092,2570
4.0,2.0,2350,8140,1.0,0.0,0.0,4.0,1430,920,1977,0,555000.0,Bellevue,98006,2350
4.0,3.0,3600,9200,1.0,0.0,4.0,4.0,2100,1500,1976,1992,1075000.0,Bellevue,98008,3600
4.0,2.0,1580,8000,1.0,0.0,0.0,3.0,1040,540,1967,2011,245000.0,FederalWay,98003,1580
2.0,1.0,1070,5824,1.0,0.0,2.0,5.0,1070,0,1949,0,319950.0,Seattle,98178,1070
3.0,1.0,1070,6109,1.0,0.0,0.0,5.0,1070,0,1951,0,337000.0,Seattle,98125,1070
4.0,2.0,1640,5000,2.0,0.0,0.0,3.0,1640,0,1907,1983,492000.0,Seattle,98107,1640
2.0,1.0,1400,4500,1.0,0.0,0.0,3.0,900,500,1922,2008,180000.0,Renton,98057,1400
3.0,1.0,1040,6250,1.0,0.0,0.0,3.0,1040,0,1942,1999,400000.0,Seattle,98136,1040
4.0,2.0,980,10640,1.0,0.0,0.0,5.0,980,0,1978,0,295000.0,NorthBend,98045,980
4.0,3.0,3340,10890,1.5,0.0,0.0,3.0,2240,1100,1963,2000,910000.0,Redmond,98052,3340
3.0,4.0,1900,1612,2.0,0.0,0.0,3.0,1430,470,2008,0,431500.0,Seattle,98136,1900
4.0,2.0,1740,7292,1.0,0.0,0.0,3.0,1020,720,1962,2003,180000.0,SeaTac,98168,1740
3.0,2.0,2000,3207,1.0,0.0,0.0,4.0,1100,900,1916,0,677000.0,Seattle,98103,2000
4.0,2.0,3240,13978,1.0,0.0,0.0,3.0,1860,1380,1977,2004,635700.0,Sammamish,98074,3240
5.0,2.0,2230,9600,1.0,0.0,0.0,3.0,1320,910,1978,0,482000.0,Woodinville,98077,2230
2.0,2.0,1160,2174,2.0,0.0,0.0,3.0,1160,0,1998,2006,168000.0,Seattle,98106,1160
4.0,3.0,2410,6000,1.0,0.0,0.0,5.0,1410,1000,1950,0,805000.0,Seattle,98107,2410
2.0,1.0,590,10945,1.5,0.0,0.0,3.0,590,0,1983,2009,398000.0,BlackDiamond,98010,590
4.0,2.0,2600,17388,2.0,0.0,0.0,3.0,2600,0,1996,0,665000.0,Newcastle,98059,2600
4.0,3.0,2170,8240,1.0,0.0,0.0,4.0,1370,800,1968,0,592500.0,Redmond,98052,2170
4.0,3.0,2080,4000,1.5,0.0,0.0,3.0,2080,0,1912,2000,940000.0,Seattle,98107,2080
4.0,2.0,2860,12394,2.0,0.0,0.0,3.0,2860,0,1999,0,655000.0,Sammamish,98075,2860
4.0,2.0,2980,8107,2.0,0.0,0.0,3.0,2980,0,2000,0,622500.0,Snoqualmie,98065,2980
2.0,2.0,1230,987,2.0,0.0,0.0,3.0,1060,170,2011,0,380000.0,Seattle,98144,1230
4.0,2.0,2260,7005,1.0,0.0,1.0,4.0,1130,1130,1947,1988,648360.0,Kirkland,98033,2260
3.0,3.0,2200,14925,1.0,0.0,0.0,3.0,1100,1100,1982,0,432000.0,Redmond,98053,2200
4.0,2.0,3030,12590,1.5,0.0,0.0,4.0,3030,0,1988,0,1050000.0,Bellevue,98004,3030
2.0,1.0,1060,1600,2.0,0.0,0.0,3.0,1060,0,1979,2014,353250.0,Seattle,98144,1060
4.0,3.0,4260,18687,2.0,0.0,0.0,3.0,4260,0,1996,0,1000000.0,Sammamish,98075,4260
3.0,2.0,998,844,2.0,0.0,0.0,3.0,798,200,2007,0,320000.0,Seattle,98117,998
4.0,2.0,2052,3723,2.0,0.0,0.0,3.0,2052,0,2014,0,349900.0,FederalWay,98003,2052
4.0,4.0,3150,6202,2.0,0.0,0.0,3.0,3150,0,2005,0,330000.0,Kent,98042,3150
3.0,2.0,1950,7221,1.0,0.0,0.0,4.0,1950,0,2006,0,408000.0,SeaTac,98188,1950
3.0,2.0,1347,1292,3.0,0.0,0.0,3.0,1347,0,2010,0,321000.0,Seattle,98125,1347
4.0,4.0,3860,5474,2.5,0.0,0.0,3.0,3860,0,2007,0,1051000.0,Issaquah,98029,3860
3.0,2.0,1360,885,3.0,0.0,0.0,3.0,1360,0,2008,0,359000.0,Seattle,98103,1360
5.0,2.0,2760,6000,2.0,0.0,0.0,3.0,2760,0,2006,0,300000.0,Seattle,98108,2760
3.0,2.0,2450,4332,2.0,0.0,0.0,3.0,2450,0,2010,0,660000.0,Redmond,98053,2450
3.0,2.0,1280,959,3.0,0.0,0.0,3.0,1280,0,2005,0,355000.0,Seattle,98103,1280
3.0,2.0,1550,3569,2.0,0.0,0.0,3.0,1550,0,2011,0,259000.0,Auburn,98002,1550
1.0,1.0,550,1279,2.0,0.0,0.0,3.0,550,0,2008,0,353000.0,Seattle,98122,550
2.0,2.0,1520,1588,2.0,0.0,0.0,3.0,1240,280,2007,0,430000.0,Seattle,98144,1520
3.0,1.0,1670,4005,1.5,0.0,0.0,4.0,1170,500,1939,1989,460000.0,Seattle,98117,1670
1.0,1.0,430,5050,1.0,0.0,0.0,2.0,430,0,1912,0,80000.0,Carnation,98014,430
4.0,2.0,2380,9614,2.0,0.0,0.0,4.0,2380,0,1991,0,782000.0,Bellevue,98006,2380
3.0,1.0,960,9633,1.0,0.0,0.0,5.0,960,0,1982,0,218000.0,Enumclaw,98022,960
3.0,1.0,1920,6862,1.0,0.0,2.0,3.0,1120,800,1952,2008,325000.0,Seattle,98118,1920
4.0,3.0,3680,5854,1.0,0.0,3.0,3.0,2060,1620,1967,2011,980000.0,Seattle,98199,3680
4.0,2.0,2530,9200,1.0,0.0,0.0,5.0,1570,960,1976,0,902000.0,Bellevue,98006,2530
5.0,2.0,3840,16905,2.0,0.0,0.0,3.0,3840,0,1991,0,556000.0,FederalWay,98023,3840
3.0,2.0,1240,3600,1.5,0.0,0.0,5.0,1240,0,1926,0,662990.0,Seattle,98116,1240
2.0,1.0,1300,11867,1.5,0.0,0.0,4.0,1300,0,1975,0,225000.0,Ravensdale,98051,1300
4.0,2.0,2380,12067,2.0,0.0,0.0,3.0,2380,0,2002,0,439950.0,Renton,98059,2380
2.0,1.0,780,13500,1.0,0.0,0.0,4.0,780,0,1946,1989,306000.0,Woodinville,98077,780
3.0,2.0,2420,12676,2.0,0.0,0.0,3.0,2420,0,1911,1986,399500.0,NorthBend,98045,2420
3.0,1.0,1280,2580,1.5,0.0,0.0,3.0,1280,0,1910,2014,478000.0,Seattle,98115,1280
2.0,1.0,1680,6500,1.0,0.0,0.0,4.0,1140,540,1941,1998,515000.0,Seattle,98136,1680
3.0,2.0,2510,5400,2.0,0.0,0.0,3.0,2510,0,1992,0,550000.0,Renton,98056,2510
3.0,1.0,1700,8645,1.0,0.0,0.0,3.0,1700,0,1955,2005,149000.0,Seattle,98146,1700
3.0,2.0,1680,3420,1.0,0.0,0.0,3.0,960,720,1992,0,526000.0,Seattle,98115,1680
3.0,2.0,2600,10092,1.0,0.0,0.0,3.0,2600,0,1984,0,625000.0,Sammamish,98074,2600
5.0,3.0,3400,7452,2.0,0.0,0.0,3.0,3400,0,1999,0,950000.0,Bellevue,98007,3400
5.0,2.0,2120,8399,1.0,0.0,0.0,4.0,1320,800,1942,1982,377691.0,Shoreline,98133,2120
4.0,3.0,2250,5700,1.0,0.0,0.0,3.0,1200,1050,1951,1994,648475.0,Seattle,98109,2250
3.0,1.0,1800,5612,1.0,0.0,0.0,4.0,1200,600,1942,1982,383000.0,Seattle,98126,1800
3.0,2.0,2210,7620,2.0,0.0,0.0,3.0,2210,0,1994,0,535000.0,Redmond,98052,2210
3.0,2.0,1560,4080,2.0,0.0,0.0,3.0,1560,0,1923,1982,449950.0,Seattle,98115,1560
3.0,3.0,1960,2500,1.5,0.0,0.0,5.0,1410,550,1926,0,599000.0,Seattle,98103,1960
3.0,2.0,1110,9762,1.0,0.0,0.0,4.0,1110,0,1963,0,416000.0,Redmond,98052,1110
2.0,2.0,1030,4500,1.0,0.0,0.0,3.0,830,200,1924,2011,595000.0,Seattle,98109,1030
3.0,2.0,1540,1827,2.0,0.0,0.0,3.0,1540,0,2005,0,402000.0,Issaquah,98029,1540
4.0,2.0,1830,9600,1.0,0.0,0.0,4.0,1010,820,1966,0,433000.0,Bellevue,98006,1830
4.0,2.0,1930,15531,2.0,0.0,0.0,3.0,1930,0,1979,2014,275000.0,FederalWay,98003,1930
3.0,2.0,1650,9641,1.5,0.0,0.0,3.0,1650,0,1983,2009,410000.0,Kirkland,98034,1650
4.0,2.0,3510,12905,1.0,0.0,2.0,3.0,2210,1300,1965,1982,554820.0,Burien,98166,3510
3.0,2.0,2390,9157,2.0,0.0,0.0,3.0,2390,0,1984,0,735000.0,Redmond,98052,2390
3.0,1.0,1230,8114,1.0,0.0,0.0,4.0,1230,0,1951,1999,607000.0,Bellevue,98004,1230
3.0,2.0,1620,7540,1.0,0.0,0.0,3.0,1310,310,1988,2000,258000.0,MapleValley,98038,1620
4.0,4.0,2290,6250,1.5,0.0,0.0,5.0,1690,600,1940,0,661254.0,Seattle,98116,2290
4.0,2.0,2840,13367,1.0,0.0,0.0,3.0,1420,1420,1952,2008,945000.0,ClydeHill,98004,2840
3.0,1.0,1080,10500,1.0,0.0,0.0,3.0,1080,0,1967,2011,132500.0,Auburn,98001,1080
3.0,2.0,1620,8645,1.0,0.0,0.0,3.0,1190,430,1973,2013,467100.0,Redmond,98052,1620
3.0,2.0,1620,3975,1.0,0.0,0.0,5.0,940,680,1926,0,641000.0,Seattle,98117,1620
3.0,1.0,1010,11244,1.0,0.0,0.0,4.0,1010,0,1947,1988,350000.0,Shoreline,98155,1010
4.0,2.0,1750,8476,1.0,0.0,0.0,4.0,1240,510,1983,0,335000.0,Renton,98058,1750
4.0,2.0,2560,10400,1.0,0.0,0.0,4.0,1280,1280,1965,0,440000.0,Issaquah,98027,2560
3.0,2.0,1120,5500,1.5,0.0,0.0,4.0,1120,0,1925,1968,464600.0,Seattle,98136,1120
2.0,1.0,1340,7788,1.0,0.0,2.0,3.0,1340,0,1947,2012,300000.0,Seattle,98178,1340
4.0,2.0,1590,6750,1.0,0.0,0.0,3.0,1590,0,1951,1994,670500.0,Seattle,98102,1590
3.0,1.0,1430,5000,1.0,0.0,0.0,4.0,1080,350,1919,1985,552000.0,Seattle,98115,1430
4.0,1.0,1450,8960,1.0,0.0,0.0,3.0,1450,0,1943,2002,244000.0,Seattle,98146,1450
4.0,3.0,3500,7200,2.0,0.0,0.0,3.0,3500,0,2005,0,788600.0,Redmond,98053,3500
3.0,2.0,1630,8702,1.0,0.0,0.0,3.0,1630,0,1987,2000,445000.0,Renton,98056,1630
4.0,2.0,1814,5000,1.0,0.0,0.0,4.0,944,870,1951,1999,530000.0,Seattle,98115,1814
2.0,1.0,580,7500,1.0,0.0,0.0,3.0,580,0,1943,2002,90000.0,Seattle,98178,580
3.0,2.0,1670,4572,1.5,0.0,0.0,3.0,1670,0,1931,0,585000.0,Seattle,98117,1670
2.0,2.0,1140,8282,1.0,0.0,0.0,3.0,1140,0,1924,2009,498000.0,Kirkland,98033,1140
2.0,1.0,800,6380,1.0,0.0,2.0,3.0,800,0,1940,1996,379000.0,Seattle,98115,800
3.0,2.0,1300,2580,1.0,0.0,0.0,5.0,820,480,1919,1934,462000.0,Seattle,98115,1300
4.0,2.0,2440,7155,2.0,0.0,0.0,3.0,2440,0,1993,0,388000.0,Renton,98058,2440
3.0,2.0,1490,8371,1.5,0.0,0.0,3.0,1490,0,1984,0,255000.0,Kent,98031,1490
3.0,3.0,1800,9550,1.0,0.0,0.0,4.0,1320,480,1966,0,665000.0,Bellevue,98006,1800
3.0,2.0,1830,9152,1.0,0.0,0.0,5.0,1830,0,1959,0,550000.0,Bellevue,98006,1830
3.0,1.0,1500,3920,1.0,0.0,0.0,3.0,1000,500,1947,2012,606000.0,Seattle,98107,1500
4.0,2.0,2210,6080,1.0,0.0,2.0,4.0,1410,800,1965,0,334000.0,Seattle,98178,2210
3.0,2.0,1270,1323,3.0,0.0,0.0,3.0,1270,0,2006,0,360000.0,Seattle,98103,1270
2.0,1.0,1140,1730,1.5,0.0,0.0,3.0,1010,130,2007,0,235000.0,Seattle,98126,1140
3.0,2.0,1620,1173,3.0,0.0,4.0,3.0,1470,150,2008,0,580000.0,Seattle,98103,1620
3.0,2.0,1220,1186,3.0,0.0,0.0,3.0,1220,0,2007,0,355000.0,Seattle,98103,1220
2.0,2.0,750,1430,2.0,0.0,0.0,3.0,750,0,2006,0,375000.0,Seattle,98122,750
4.0,2.0,1960,9300,1.0,0.0,0.0,5.0,1340,620,1979,0,372000.0,NorthBend,98045,1960
3.0,1.0,1370,3000,1.5,0.0,0.0,3.0,1370,0,1924,2011,479000.0,Seattle,98103,1370
2.0,1.0,1010,4320,1.0,0.0,0.0,5.0,1010,0,1924,1956,501000.0,Seattle,98115,1010
3.0,2.0,1260,6908,1.0,0.0,0.0,3.0,1260,0,1994,0,245000.0,MapleValley,98038,1260
3.0,2.0,1740,5782,2.0,0.0,0.0,4.0,1740,0,1989,0,496700.0,Issaquah,98029,1740
4.0,2.0,2670,10026,2.0,0.0,0.0,3.0,2670,0,1996,0,347000.0,Auburn,98092,2670
2.0,1.0,720,7200,1.0,0.0,0.0,5.0,720,0,1943,0,199000.0,Renton,98058,720
3.0,2.0,2460,4399,2.0,0.0,0.0,3.0,2460,0,2007,0,440500.0,Snoqualmie,98065,2460
4.0,2.0,3670,7000,2.0,0.0,0.0,3.0,3670,0,2005,0,820000.0,Sammamish,98075,3670
4.0,4.0,2630,3435,1.5,0.0,3.0,3.0,1640,990,1984,0,325000.0,SeaTac,98188,2630
3.0,2.0,1570,8459,1.0,0.0,0.0,3.0,1570,0,1991,0,195000.0,Enumclaw,98022,1570
3.0,2.0,1560,4200,2.0,0.0,0.0,3.0,1560,0,2003,0,295000.0,MapleValley,98038,1560
3.0,2.0,1620,7410,1.0,0.0,0.0,5.0,1620,0,1955,0,355300.0,Shoreline,98133,1620
3.0,1.0,1140,5000,1.0,0.0,0.0,3.0,1140,0,1960,2012,276000.0,Seattle,98106,1140
3.0,2.0,1780,4050,2.0,0.0,0.0,3.0,1780,0,2001,0,370000.0,Shoreline,98155,1780
4.0,2.0,2100,3916,2.0,0.0,0.0,3.0,2100,0,2009,0,346000.0,Renton,98058,2100
3.0,1.0,1140,8800,1.0,0.0,0.0,3.0,1140,0,1972,2002,172500.0,Auburn,98001,1140
3.0,2.0,1690,9144,1.0,0.0,0.0,4.0,1140,550,1956,0,379950.0,Kenmore,98028,1690
2.0,1.0,1160,6000,1.0,0.0,0.0,4.0,860,300,1942,1982,468000.0,Seattle,98115,1160
4.0,3.0,1720,6270,2.0,0.0,0.0,3.0,1720,0,1978,0,477000.0,Seattle,98118,1720
3.0,1.0,1210,3328,1.5,0.0,0.0,4.0,1210,0,1924,0,529000.0,Seattle,98107,1210
2.0,1.0,880,7683,1.0,0.0,0.0,3.0,880,0,1942,1999,326100.0,Seattle,98177,880
3.0,1.0,1050,9206,1.5,0.0,0.0,3.0,1050,0,1954,2005,360000.0,Seattle,98125,1050
3.0,2.0,1650,12940,1.0,0.0,0.0,4.0,1650,0,1961,2001,438000.0,Kenmore,98028,1650
3.0,1.0,1570,9467,1.0,0.0,0.0,3.0,1570,0,1954,2005,360000.0,Shoreline,98177,1570
4.0,2.0,2920,7200,1.0,0.0,3.0,3.0,1470,1450,1921,2006,1050000.0,Seattle,98144,2920
4.0,3.0,3000,4000,1.5,0.0,3.0,3.0,1970,1030,1913,2014,688000.0,Seattle,98144,3000
3.0,2.0,1850,7735,1.0,0.0,0.0,4.0,1850,0,1983,0,585000.0,Issaquah,98027,1850
3.0,2.0,1440,7741,1.0,0.0,0.0,4.0,1000,440,1983,0,265000.0,Kent,98031,1440
3.0,2.0,1440,8775,1.0,0.0,0.0,3.0,1440,0,1973,2013,375000.0,Kirkland,98034,1440
3.0,1.0,1810,12375,2.0,0.0,0.0,3.0,1810,0,1970,2014,326500.0,Woodinville,98072,1810
2.0,1.0,1180,9350,1.0,0.0,0.0,3.0,1180,0,1918,0,160000.0,Seattle,98178,1180
2.0,1.0,1470,6120,1.0,0.0,0.0,2.0,1470,0,1940,0,400000.0,Seattle,98115,1470
4.0,2.0,2680,7200,1.0,0.0,0.0,3.0,1380,1300,1952,2013,800000.0,Kirkland,98033,2680
4.0,2.0,2290,10687,2.0,0.0,0.0,3.0,2290,0,1978,0,949880.0,Bellevue,98004,2290
3.0,2.0,1980,8100,1.0,0.0,0.0,4.0,1310,670,1949,1985,405000.0,Shoreline,98133,1980
4.0,2.0,2870,9292,2.0,0.0,0.0,3.0,2540,330,1979,2014,399000.0,Renton,98058,2870
3.0,2.0,1840,4750,1.0,0.0,0.0,5.0,1010,830,1951,0,730001.0,Seattle,98117,1840
3.0,2.0,1630,8018,1.0,0.0,0.0,3.0,1630,0,2003,0,260000.0,Pacific,98047,1630
2.0,2.0,1880,5400,1.5,0.0,0.0,3.0,1880,0,1902,0,751750.0,Seattle,98112,1880
3.0,2.0,1780,13095,1.0,0.0,0.0,4.0,1780,0,1983,0,325000.0,Kent,98042,1780
4.0,2.0,2330,6250,1.0,0.0,0.0,4.0,1400,930,1941,1998,344950.0,Kent,98030,2330
3.0,2.0,1840,4030,1.0,0.0,0.0,5.0,1050,790,1925,0,457500.0,Seattle,98108,1840
5.0,2.0,2330,10750,1.0,0.0,0.0,4.0,1190,1140,1962,0,389000.0,Kenmore,98028,2330
4.0,2.0,3200,6473,2.0,0.0,0.0,3.0,3200,0,2005,0,515000.0,Renton,98059,3200
3.0,2.0,1950,8868,1.0,0.0,0.0,3.0,1350,600,1964,2000,415000.0,Shoreline,98155,1950
2.0,1.0,1040,5527,1.0,0.0,0.0,3.0,1040,0,1951,1994,535000.0,Seattle,98115,1040
4.0,4.0,1960,3565,2.0,0.0,0.0,3.0,1960,0,1940,2003,540000.0,Seattle,98116,1960
5.0,3.0,2750,3800,1.5,0.0,0.0,5.0,1750,1000,1926,0,525000.0,Seattle,98115,2750
3.0,3.0,2640,4050,1.5,0.0,0.0,5.0,1750,890,1926,0,1100000.0,Seattle,98112,2640
4.0,2.0,1940,9144,1.0,0.0,0.0,4.0,1430,510,1956,0,495000.0,Bellevue,98007,1940
5.0,3.0,2840,7199,1.0,0.0,0.0,3.0,1710,1130,2003,0,292050.0,Tukwila,98178,2840
5.0,2.0,1900,10226,1.0,0.0,0.0,3.0,1130,770,1961,2004,415000.0,Kirkland,98034,1900
5.0,1.0,1410,6400,1.0,0.0,0.0,5.0,960,450,1955,0,295832.0,DesMoines,98198,1410
4.0,2.0,2520,8515,2.0,0.0,0.0,3.0,2520,0,1999,0,450000.0,Duvall,98019,2520
3.0,4.0,1820,1501,2.0,0.0,0.0,3.0,1430,390,2014,0,499950.0,Seattle,98144,1820
3.0,2.0,1560,8640,1.0,0.0,0.0,5.0,1560,0,1967,0,465000.0,Kirkland,98034,1560
3.0,1.0,1600,5952,1.0,0.0,0.0,4.0,1150,450,1964,0,329000.0,Seattle,98106,1600
3.0,2.0,1230,11502,1.0,0.0,0.0,4.0,1230,0,1984,0,475000.0,Redmond,98052,1230
3.0,1.0,960,8100,1.0,0.0,0.0,3.0,960,0,1955,2005,255000.0,Shoreline,98155,960
3.0,1.0,1270,4000,1.5,0.0,2.0,3.0,1270,0,1928,1954,435000.0,Seattle,98126,1270
3.0,2.0,2810,7700,2.0,0.0,0.0,3.0,2810,0,2001,0,685000.0,Bellevue,98006,2810
2.0,2.0,2160,5581,1.0,0.0,0.0,3.0,2160,0,2002,0,715000.0,Redmond,98053,2160
3.0,3.0,2520,2152,1.5,0.0,0.0,3.0,1560,960,1925,2006,780000.0,Seattle,98119,2520
2.0,2.0,1180,844,2.0,0.0,0.0,3.0,990,190,2005,0,345000.0,Seattle,98144,1180
4.0,2.0,1810,4970,2.0,0.0,0.0,3.0,1810,0,2003,0,355000.0,Renton,98059,1810
3.0,2.0,1680,15711,1.0,0.0,0.0,3.0,1240,440,1994,0,282000.0,Kent,98031,1680
3.0,1.0,910,5250,1.0,0.0,0.0,4.0,910,0,1971,0,244000.0,Burien,98166,910
3.0,4.0,3250,5797,2.0,0.0,2.0,4.0,2370,880,1951,1999,967500.0,Seattle,98199,3250
3.0,2.0,2000,7294,1.0,0.0,0.0,3.0,1520,480,1965,1993,375000.0,Seattle,98118,2000
3.0,2.0,2510,6339,1.5,0.0,2.0,5.0,1810,700,1932,2002,994000.0,Seattle,98199,2510
3.0,2.0,1320,6205,1.0,0.0,0.0,5.0,1320,0,1948,1985,313000.0,Shoreline,98133,1320
3.0,1.0,900,7500,1.0,0.0,0.0,4.0,900,0,1972,0,304000.0,Kirkland,98034,900
3.0,2.0,2540,7680,2.0,0.0,1.0,4.0,2540,0,1940,2001,675000.0,Seattle,98177,2540
4.0,1.0,2100,9288,1.0,0.0,0.0,4.0,1050,1050,1968,0,305000.0,Renton,98058,2100
3.0,1.0,1200,6250,1.0,0.0,0.0,3.0,920,280,1943,2002,280000.0,Seattle,98168,1200
5.0,4.0,3720,15200,2.0,0.0,0.0,3.0,3720,0,2005,0,960000.0,Sammamish,98075,3720
3.0,2.0,1760,4539,2.0,0.0,0.0,3.0,1760,0,1988,2000,500000.0,Issaquah,98029,1760
3.0,2.0,1670,7415,1.0,0.0,0.0,3.0,1320,350,1987,2000,274950.0,Covington,98042,1670
3.0,2.0,2420,8252,2.0,0.0,0.0,3.0,2420,0,1998,2006,455600.0,Snoqualmie,98065,2420
5.0,3.0,3480,15185,2.0,0.0,0.0,4.0,3480,0,1964,0,970000.0,MercerIsland,98040,3480
4.0,2.0,1630,4473,2.0,0.0,0.0,3.0,1630,0,2003,0,312900.0,MapleValley,98038,1630
4.0,2.0,2340,5600,2.0,0.0,0.0,3.0,2340,0,1921,2013,535000.0,Seattle,98146,2340
2.0,1.0,920,3780,1.0,0.0,0.0,3.0,920,0,1910,2006,427000.0,Seattle,98103,920
2.0,1.0,910,6490,1.0,0.0,0.0,3.0,910,0,1942,1999,405000.0,Seattle,98115,910
3.0,1.0,1150,4945,1.0,0.0,2.0,3.0,1150,0,1943,2002,480000.0,Seattle,98126,1150
3.0,2.0,2500,4774,1.5,0.0,2.0,3.0,1450,1050,1940,1996,725000.0,Seattle,98107,2500
4.0,2.0,1930,6600,1.0,0.0,0.0,4.0,1030,900,1967,0,268000.0,Burien,98168,1930
3.0,2.0,1590,2550,3.0,0.0,0.0,3.0,1590,0,1985,0,488000.0,Seattle,98117,1590
4.0,2.0,3330,7399,2.0,0.0,0.0,3.0,3330,0,2009,0,760000.0,Redmond,98052,3330
3.0,2.0,2610,7256,2.0,0.0,0.0,3.0,2610,0,2014,0,754950.0,Kirkland,98033,2610
3.0,2.0,1658,2700,2.0,0.0,0.0,3.0,1658,0,2014,0,263900.0,DesMoines,98198,1658
3.0,4.0,1600,1431,2.0,0.0,0.0,3.0,1240,360,2006,0,460000.0,Seattle,98117,1600
3.0,3.0,1296,1051,3.0,0.0,0.0,3.0,1296,0,2009,0,399950.0,Seattle,98125,1296
2.0,2.0,1280,835,2.0,0.0,0.0,3.0,1080,200,2009,0,370000.0,Seattle,98118,1280
4.0,3.0,2510,5311,2.0,0.0,0.0,3.0,2510,0,2009,0,450800.0,Renton,98056,2510
3.0,4.0,2710,3475,2.0,0.0,0.0,3.0,1650,1060,2005,0,627000.0,Issaquah,98027,2710
2.0,1.0,1320,8865,1.0,0.0,0.0,4.0,1320,0,1943,0,215000.0,Burien,98168,1320
3.0,2.0,2495,4400,2.0,0.0,0.0,3.0,2495,0,2007,0,267000.0,FederalWay,98001,2495
3.0,2.0,1300,12240,1.0,0.0,0.0,3.0,1300,0,1963,2008,365000.0,Kenmore,98028,1300
4.0,2.0,2230,10414,1.0,0.0,0.0,5.0,1450,780,1974,0,544500.0,Issaquah,98075,2230
4.0,3.0,2020,2750,1.0,0.0,0.0,3.0,1010,1010,1917,2014,599000.0,Seattle,98122,2020
4.0,2.0,2000,3800,2.0,0.0,0.0,3.0,2000,0,2001,0,815000.0,Seattle,98115,2000
2.0,1.0,1060,8187,1.0,0.0,0.0,4.0,1060,0,1952,0,254000.0,Shoreline,98133,1060
2.0,2.0,2080,4800,1.0,0.0,0.0,5.0,1080,1000,1923,0,740000.0,Seattle,98117,2080
3.0,2.0,2690,7000,2.0,0.0,0.0,5.0,1840,850,1943,0,925000.0,Seattle,98115,2690
3.0,2.0,1550,12920,2.0,0.0,0.0,5.0,1550,0,1999,0,537000.0,Kirkland,98033,1550
4.0,2.0,1480,3132,1.0,0.0,0.0,5.0,740,740,1910,0,335000.0,Seattle,98108,1480
4.0,3.0,3040,2800,2.0,0.0,0.0,3.0,2100,940,1906,2014,840000.0,Seattle,98102,3040
3.0,2.0,1560,7300,1.0,0.0,0.0,4.0,1040,520,1964,0,224000.0,Auburn,98001,1560
3.0,2.0,2250,3757,2.0,0.0,0.0,3.0,2250,0,2006,0,395000.0,Renton,98059,2250
3.0,1.0,1100,4600,1.0,0.0,0.0,3.0,1100,0,1917,2009,450000.0,Seattle,98116,1100
3.0,1.0,1700,6356,1.5,0.0,0.0,3.0,1700,0,1907,1983,681000.0,Seattle,98118,1700
3.0,1.0,800,2296,1.0,0.0,0.0,4.0,800,0,1908,0,370000.0,Seattle,98103,800
2.0,2.0,1350,6315,1.0,0.0,0.0,3.0,1350,0,2005,0,429000.0,Redmond,98053,1350
3.0,1.0,820,7680,1.5,0.0,0.0,3.0,820,0,1910,2006,150000.0,Seattle,98106,820
3.0,2.0,3160,4270,2.0,0.0,0.0,3.0,2650,510,2006,0,555000.0,Bothell,98011,3160
3.0,2.0,1680,6755,2.0,0.0,0.0,3.0,1680,0,1994,0,225000.0,Auburn,98092,1680
3.0,2.0,1300,7958,1.0,0.0,0.0,3.0,1300,0,1996,0,245100.0,Auburn,98092,1300
3.0,2.0,2190,10370,2.0,0.0,0.0,3.0,2190,0,1987,2000,665000.0,Sammamish,98074,2190
3.0,2.0,1720,4006,2.0,0.0,0.0,3.0,1720,0,1994,0,535000.0,Issaquah,98029,1720
3.0,1.0,1160,11776,1.0,0.0,0.0,3.0,1160,0,1968,1997,305000.0,Woodinville,98077,1160
3.0,2.0,1210,8075,1.0,0.0,0.0,4.0,1210,0,1983,0,215000.0,Pacific,98047,1210
3.0,2.0,1980,5100,1.0,0.0,0.0,3.0,1270,710,1965,1993,432500.0,Seattle,98103,1980
4.0,2.0,2990,5669,2.0,0.0,0.0,3.0,2990,0,2003,0,655000.0,Sammamish,98074,2990
3.0,2.0,1430,9600,1.0,0.0,0.0,4.0,1430,0,1966,0,266200.0,Renton,98059,1430
3.0,2.0,2060,4030,2.0,0.0,0.0,3.0,2060,0,1999,0,244615.0,Kent,98032,2060
4.0,2.0,3090,18645,2.0,0.0,0.0,3.0,3090,0,1995,0,370000.0,FederalWay,98023,3090
2.0,2.0,1700,3171,1.0,0.0,0.0,5.0,850,850,1927,0,189000.0,Auburn,98002,1700
3.0,2.0,2510,5503,2.0,0.0,2.0,3.0,2510,0,1995,0,820000.0,Seattle,98136,2510
6.0,3.0,3610,17580,1.0,0.0,4.0,5.0,2070,1540,1959,0,968000.0,Sammamish,98075,3610
3.0,2.0,1610,6480,1.0,0.0,0.0,4.0,1610,0,1947,1988,438750.0,Seattle,98125,1610
3.0,1.0,1110,6000,1.5,0.0,0.0,5.0,1110,0,1932,2002,589000.0,Seattle,98199,1110
3.0,2.0,1650,6150,2.0,0.0,0.0,4.0,1650,0,1926,1993,590000.0,Seattle,98116,1650
3.0,2.0,1980,12150,1.0,0.0,0.0,3.0,1980,0,1994,0,479900.0,Kent,98042,1980
2.0,2.0,880,1157,2.0,0.0,0.0,3.0,880,0,2007,0,210000.0,Seattle,98126,880
3.0,2.0,1490,9800,1.0,0.0,0.0,4.0,1140,350,1947,1988,745000.0,BeauxArtsVillage,98004,1490
3.0,2.0,2520,5400,1.5,0.0,0.0,4.0,1410,1110,1906,1990,840500.0,Seattle,98119,2520
7.0,4.0,4140,9066,1.0,0.0,0.0,3.0,2070,2070,1978,0,565000.0,Seattle,98125,4140
4.0,2.0,3420,8405,2.0,0.0,0.0,3.0,3420,0,2000,0,840000.0,Sammamish,98074,3420
4.0,2.0,3150,7277,2.0,0.0,0.0,3.0,3150,0,2006,0,681716.0,Renton,98056,3150
3.0,2.0,1580,7416,1.0,0.0,0.0,3.0,1150,430,1967,2011,600000.0,Bellevue,98005,1580
3.0,2.0,1660,8281,1.0,0.0,0.0,3.0,1660,0,1949,1998,380000.0,Seattle,98136,1660
3.0,1.0,1100,10125,1.0,0.0,0.0,3.0,1100,0,1969,2010,168500.0,Covington,98042,1100
2.0,1.0,1270,3200,1.0,0.0,0.0,4.0,960,310,1920,0,355000.0,Seattle,98103,1270
4.0,1.0,1450,6250,1.0,0.0,0.0,3.0,990,460,1964,2000,277000.0,Seattle,98146,1450
4.0,2.0,1830,9485,1.0,0.0,0.0,4.0,1200,630,1989,0,236000.0,FederalWay,98023,1830
3.0,2.0,1300,4127,1.0,0.0,0.0,4.0,650,650,1918,1953,270000.0,Seattle,98106,1300
2.0,2.0,2320,5500,1.5,0.0,2.0,3.0,1720,600,1925,2000,700000.0,Seattle,98144,2320
4.0,3.0,1680,9545,1.0,0.0,0.0,4.0,1080,600,1979,0,425000.0,Kenmore,98028,1680
3.0,2.0,2300,5500,1.5,0.0,0.0,4.0,2000,300,1921,0,635000.0,Seattle,98144,2300
3.0,2.0,1400,4000,1.0,0.0,0.0,3.0,870,530,1951,1994,510250.0,Seattle,98117,1400
4.0,2.0,2410,4560,2.0,0.0,2.0,5.0,1800,610,1929,0,960000.0,Seattle,98117,2410
3.0,2.0,1480,7480,1.0,0.0,0.0,4.0,1480,0,1992,0,254000.0,MapleValley,98038,1480
3.0,1.0,1390,9624,1.5,0.0,0.0,4.0,1390,0,1954,1979,299000.0,Shoreline,98155,1390
2.0,1.0,830,2699,1.0,0.0,0.0,3.0,830,0,1996,0,175000.0,MapleValley,98038,830
2.0,1.0,740,9003,1.0,0.0,0.0,3.0,740,0,1949,1998,157500.0,Kent,98031,740
5.0,2.0,1940,6000,1.0,0.0,0.0,5.0,970,970,1945,0,580000.0,Seattle,98115,1940
3.0,1.0,1340,15600,1.0,0.0,0.0,4.0,1340,0,1978,2000,124740.0,Kent,98042,1340
2.0,1.0,800,6240,1.0,0.0,0.0,3.0,800,0,1954,2005,285000.0,Seattle,98125,800
3.0,2.0,1310,9645,1.0,0.0,0.0,3.0,1310,0,1979,2014,242000.0,SeaTac,98198,1310
4.0,2.0,2330,4000,2.0,0.0,0.0,5.0,1300,1030,1924,1956,840000.0,Seattle,98105,2330
2.0,3.0,1400,1243,3.0,0.0,0.0,3.0,1400,0,2000,0,474800.0,Seattle,98103,1400
4.0,2.0,2360,4367,2.0,0.0,0.0,3.0,2360,0,2003,0,490000.0,Woodinville,98072,2360
3.0,2.0,1840,5752,2.0,0.0,0.0,3.0,1840,0,2003,0,465000.0,Kirkland,98034,1840
3.0,4.0,3890,7140,1.0,0.0,2.0,3.0,2390,1500,1943,2007,430000.0,Seattle,98178,3890
3.0,2.0,1400,8640,1.0,0.0,0.0,5.0,1400,0,1968,0,253400.0,FederalWay,98003,1400
3.0,2.0,2400,9701,1.0,0.0,0.0,3.0,2400,0,1990,2009,355000.0,FederalWay,98023,2400
2.0,2.0,1390,1302,2.0,0.0,0.0,3.0,1390,0,1986,0,186950.0,FederalWay,98003,1390
3.0,2.0,1680,11193,2.0,0.0,0.0,3.0,1680,0,1984,0,306000.0,Renton,98058,1680
4.0,2.0,2040,8800,1.0,0.0,0.0,4.0,1020,1020,1961,2001,510000.0,Bellevue,98007,2040
2.0,1.0,1080,4000,1.0,0.0,0.0,3.0,1080,0,1940,1996,345000.0,Seattle,98117,1080
3.0,3.0,2280,4280,1.0,0.0,0.0,5.0,1280,1000,1917,0,875000.0,Seattle,98103,2280
4.0,4.0,4490,5099,2.0,0.0,0.0,3.0,3390,1100,2006,0,700000.0,Snoqualmie,98065,4490
3.0,2.0,2810,5400,2.0,0.0,0.0,3.0,2810,0,2005,0,739000.0,Redmond,98052,2810
4.0,2.0,3753,7204,2.0,0.0,0.0,3.0,3336,417,2008,0,363000.0,FederalWay,98023,3753
4.0,4.0,3910,8095,2.0,0.0,0.0,3.0,3130,780,2007,0,782000.0,Issaquah,98029,3910
2.0,2.0,1050,1609,2.0,0.0,0.0,3.0,1050,0,2005,0,325000.0,Seattle,98144,1050
4.0,1.0,1600,4300,1.5,0.0,0.0,4.0,1600,0,1916,0,485000.0,Seattle,98103,1600
4.0,2.0,2590,10002,1.0,0.0,0.0,4.0,1340,1250,1968,0,452000.0,Kenmore,98028,2590
4.0,2.0,1720,9753,1.0,0.0,0.0,4.0,1120,600,1978,2000,264950.0,FederalWay,98023,1720
6.0,2.0,4410,14034,1.0,0.0,2.0,4.0,2350,2060,1965,0,472000.0,FederalWay,98003,4410
3.0,2.0,1590,11914,1.0,0.0,2.0,3.0,1090,500,1957,2000,267500.0,SeaTac,98188,1590
3.0,2.0,1360,1016,3.0,0.0,0.0,3.0,1310,50,2003,0,535000.0,Seattle,98115,1360
2.0,1.0,910,7000,1.0,0.0,0.0,3.0,910,0,1952,2008,389000.0,Seattle,98115,910
4.0,2.0,1390,7200,1.0,0.0,0.0,3.0,1140,250,1965,1993,400000.0,Seattle,98133,1390
3.0,2.0,1470,14821,1.0,0.0,0.0,4.0,1470,0,1958,1972,264000.0,Kent,98042,1470
4.0,2.0,2920,9904,2.0,0.0,0.0,4.0,2920,0,1990,0,690000.0,Issaquah,98029,2920
3.0,2.0,2390,4555,2.0,0.0,0.0,3.0,2390,0,2006,0,695000.0,Sammamish,98074,2390
3.0,2.0,1270,11600,1.0,0.0,0.0,4.0,1270,0,1964,0,246500.0,Kent,98031,1270
2.0,1.0,950,7560,1.0,0.0,0.0,3.0,950,0,1958,2004,230000.0,Renton,98058,950
4.0,2.0,2280,6660,1.5,0.0,2.0,3.0,1960,320,1940,1984,820000.0,Seattle,98119,2280
3.0,1.0,1010,5490,1.0,0.0,0.0,3.0,1010,0,1954,2005,145000.0,SeaTac,98168,1010
2.0,1.0,1260,5000,1.0,0.0,0.0,3.0,1040,220,1951,1994,436500.0,Seattle,98117,1260
3.0,2.0,2330,4000,1.5,0.0,2.0,5.0,1520,810,1927,0,680000.0,Seattle,98115,2330
5.0,3.0,2170,2440,1.5,0.0,0.0,4.0,1450,720,1911,1966,750500.0,Seattle,98105,2170
4.0,2.0,1880,7632,1.0,0.0,0.0,4.0,1180,700,1978,2000,266500.0,FederalWay,98023,1880
4.0,2.0,2300,3400,1.5,0.0,0.0,5.0,1550,750,1915,0,619000.0,Seattle,98117,2300
3.0,2.0,1240,14404,1.0,0.0,0.0,3.0,1240,0,1988,2000,405000.0,Redmond,98053,1240
2.0,1.0,820,3844,1.0,0.0,0.0,4.0,820,0,1916,0,300000.0,Seattle,98133,820
4.0,2.0,1530,6375,2.0,0.0,0.0,3.0,1530,0,1942,1983,231000.0,Renton,98058,1530
5.0,3.0,2900,12160,1.0,0.0,0.0,4.0,1890,1010,1967,0,790000.0,Bellevue,98005,2900
4.0,3.0,1240,3867,1.0,0.0,0.0,3.0,800,440,1987,2000,400000.0,Seattle,98125,1240
4.0,4.0,4140,13392,2.0,0.0,0.0,3.0,4140,0,2000,0,950000.0,Newcastle,98059,4140
4.0,2.0,2240,7725,1.0,0.0,0.0,5.0,1120,1120,1956,0,450000.0,Seattle,98106,2240
3.0,2.0,1480,5000,1.0,0.0,0.0,4.0,750,730,1928,0,595000.0,Seattle,98117,1480
3.0,2.0,2270,8876,1.0,0.0,0.0,3.0,1380,890,1977,2004,332000.0,Renton,98058,2270
3.0,1.0,1250,6250,1.0,0.0,0.0,2.0,1030,220,1949,0,155000.0,Seattle,98108,1250
5.0,2.0,1930,9747,1.0,0.0,0.0,4.0,1020,910,1962,0,400000.0,Kenmore,98028,1930
4.0,2.0,1700,7800,1.0,0.0,0.0,5.0,1120,580,1981,0,349000.0,Renton,98059,1700
3.0,1.0,1590,6420,1.0,0.0,0.0,3.0,1590,0,1944,0,529000.0,Seattle,98136,1590
5.0,2.0,1880,10000,1.0,0.0,0.0,3.0,960,920,1963,2008,405000.0,Kirkland,98034,1880
4.0,2.0,1640,4240,1.0,0.0,0.0,5.0,920,720,1921,0,635200.0,Seattle,98117,1640
3.0,2.0,2600,5085,1.0,0.0,0.0,4.0,1400,1200,1940,2001,540000.0,Seattle,98126,2600
2.0,1.0,710,1173,2.0,0.0,0.0,4.0,710,0,1943,0,402000.0,Seattle,98102,710
3.0,2.0,1460,5040,1.0,0.0,0.0,3.0,1100,360,1971,0,329932.0,Seattle,98133,1460
3.0,2.0,2080,9827,2.0,0.0,0.0,3.0,2080,0,1989,0,300000.0,FederalWay,98023,2080
5.0,2.0,2630,9216,2.0,0.0,0.0,3.0,2630,0,2003,0,525000.0,Duvall,98019,2630
4.0,2.0,2760,6850,2.0,0.0,0.0,3.0,2760,0,1999,0,602500.0,Newcastle,98056,2760
4.0,2.0,1670,12056,1.0,0.0,0.0,3.0,1670,0,1955,2005,400000.0,Kenmore,98028,1670
4.0,2.0,1990,4725,1.5,0.0,0.0,4.0,1190,800,1944,0,445000.0,Seattle,98126,1990
3.0,3.0,2600,5238,1.5,0.0,3.0,3.0,1890,710,1989,0,525000.0,DesMoines,98198,2600
2.0,1.0,1320,1824,1.5,0.0,0.0,4.0,1320,0,1909,1989,395000.0,Seattle,98144,1320
3.0,2.0,2240,3800,2.0,0.0,0.0,3.0,1370,870,1929,0,510000.0,Seattle,98115,2240
4.0,2.0,1960,8680,1.0,0.0,0.0,4.0,1290,670,1959,0,723000.0,Bellevue,98004,1960
4.0,3.0,2620,6707,2.0,0.0,0.0,3.0,2620,0,2000,0,672500.0,Sammamish,98075,2620
3.0,2.0,2770,9136,2.0,0.0,0.0,3.0,2770,0,1991,0,860000.0,Bellevue,98006,2770
3.0,1.0,2110,10005,1.0,0.0,0.0,5.0,1110,1000,1924,1956,475300.0,Kirkland,98033,2110
4.0,2.0,2290,4539,2.0,0.0,0.0,3.0,2290,0,2001,0,295000.0,Renton,98058,2290
4.0,3.0,3310,6166,2.0,0.0,0.0,3.0,3310,0,2008,0,658000.0,Snoqualmie,98065,3310
2.0,1.0,900,8580,1.0,0.0,0.0,3.0,900,0,1918,0,83000.0,Tukwila,98168,900
3.0,2.0,1940,7313,1.0,0.0,1.0,4.0,1440,500,1960,2001,685000.0,Seattle,98136,1940
3.0,2.0,1590,7617,2.0,0.0,0.0,3.0,1590,0,1986,0,210000.0,DesMoines,98198,1590
3.0,2.0,2930,6050,2.0,0.0,0.0,3.0,2930,0,2008,0,650880.0,Snoqualmie,98065,2930
2.0,2.0,1000,905,3.0,0.0,0.0,3.0,1000,0,2006,0,305000.0,Seattle,98117,1000
3.0,3.0,1730,1229,2.0,0.0,2.0,3.0,1320,410,2008,0,645000.0,Seattle,98119,1730
3.0,1.0,1220,4800,1.0,0.0,0.0,3.0,1220,0,1901,0,385000.0,Seattle,98122,1220
3.0,2.0,3060,12095,2.0,0.0,0.0,3.0,3060,0,1983,2009,860000.0,Bellevue,98006,3060
4.0,2.0,2910,5000,2.0,0.0,0.0,3.0,2910,0,2002,0,395000.0,Covington,98042,2910
3.0,2.0,1050,5850,1.0,0.0,0.0,3.0,1050,0,1980,0,260000.0,Burien,98166,1050
3.0,2.0,1560,7352,1.0,0.0,0.0,3.0,1560,0,1992,0,196440.0,Algona,98001,1560
3.0,2.0,1550,8509,1.0,0.0,0.0,3.0,1150,400,1959,1989,369000.0,Seattle,98106,1550
3.0,2.0,2200,7278,2.0,0.0,0.0,3.0,2200,0,1990,2009,349900.0,Renton,98058,2200
2.0,2.0,1740,2500,2.0,0.0,2.0,3.0,1210,530,1994,0,650000.0,Seattle,98112,1740
3.0,1.0,1210,9525,1.0,0.0,0.0,3.0,1210,0,1955,2005,299950.0,Seattle,98106,1210
3.0,2.0,1590,11745,1.0,0.0,0.0,3.0,1090,500,1978,0,190000.0,Auburn,98001,1590
4.0,2.0,3420,7200,1.0,0.0,3.0,5.0,1770,1650,1947,0,715000.0,Seattle,98125,3420
4.0,2.0,3190,11375,1.0,0.0,0.0,5.0,2210,980,1946,0,659000.0,Seattle,98125,3190
3.0,2.0,1920,5405,1.0,0.0,2.0,4.0,960,960,1947,1988,490000.0,Seattle,98126,1920
3.0,2.0,1700,8400,1.0,0.0,0.0,3.0,1460,240,1947,2012,750000.0,Seattle,98199,1700
4.0,2.0,2310,3570,1.5,0.0,0.0,3.0,1490,820,1927,2014,700000.0,Seattle,98103,2310
3.0,2.0,2670,10082,1.0,0.0,0.0,3.0,2670,0,1987,2000,642000.0,Sammamish,98074,2670
4.0,2.0,2060,8470,1.0,0.0,0.0,3.0,1440,620,1983,2009,655000.0,Bellevue,98006,2060
2.0,2.0,1240,1546,2.0,0.0,0.0,3.0,1240,0,2007,0,330000.0,Seattle,98108,1240
3.0,2.0,1860,3690,2.0,0.0,0.0,3.0,1860,0,2000,0,384950.0,Kenmore,98028,1860
3.0,2.0,2000,7350,1.0,0.0,0.0,3.0,2000,0,1953,0,560000.0,Seattle,98177,2000
3.0,2.0,1820,8058,1.0,0.0,0.0,3.0,1260,560,1974,0,425000.0,Kirkland,98034,1820
3.0,2.0,1060,5750,1.0,0.0,0.0,3.0,1060,0,1981,2013,315000.0,Seattle,98126,1060
3.0,2.0,1950,9906,2.0,0.0,0.0,3.0,1950,0,1988,2000,530000.0,Sammamish,98074,1950
2.0,1.0,940,4800,1.0,0.0,0.0,4.0,940,0,1911,1955,399000.0,Seattle,98116,940
2.0,2.0,1220,3568,1.5,0.0,0.0,4.0,1220,0,1976,1992,168000.0,DesMoines,98198,1220
3.0,1.0,1200,9800,1.0,0.0,0.0,4.0,1200,0,1971,0,374000.0,Woodinville,98072,1200
5.0,4.0,3990,18897,2.0,0.0,0.0,3.0,3090,900,1937,2010,740000.0,Seattle,98125,3990
2.0,1.0,1880,7560,1.0,0.0,0.0,3.0,940,940,1919,2001,280000.0,Seattle,98126,1880
4.0,2.0,2280,7200,2.0,0.0,0.0,3.0,2280,0,1994,0,322000.0,Kent,98030,2280
3.0,2.0,2580,11000,1.0,0.0,0.0,4.0,1290,1290,1951,1999,459900.0,Bellevue,98006,2580
4.0,3.0,2600,4674,1.0,0.0,0.0,3.0,1560,1040,1976,0,750000.0,Seattle,98115,2600
5.0,3.0,2220,4000,1.0,0.0,0.0,3.0,1230,990,1973,2013,427000.0,Seattle,98144,2220
4.0,3.0,2840,4120,1.5,0.0,0.0,4.0,2060,780,1931,0,735000.0,Seattle,98118,2840
4.0,2.0,2560,8780,2.0,0.0,0.0,3.0,2560,0,1992,0,642000.0,Issaquah,98029,2560
2.0,1.0,1890,5202,1.5,0.0,0.0,4.0,1890,0,1909,1989,645500.0,Seattle,98117,1890
3.0,2.0,2180,10230,1.0,0.0,0.0,4.0,1090,1090,1961,2001,325000.0,Seattle,98118,2180
3.0,2.0,2780,11964,2.0,0.0,0.0,3.0,2780,0,2009,0,825500.0,Kirkland,98034,2780
4.0,4.0,3760,5000,2.0,0.0,0.0,3.0,2860,900,2014,0,919204.0,Seattle,98117,3760
5.0,3.0,2080,13189,2.0,0.0,0.0,3.0,2080,0,1987,2000,538888.0,Sammamish,98074,2080
3.0,2.0,2460,12028,2.0,0.0,0.0,3.0,2460,0,1996,0,693000.0,Redmond,98052,2460
4.0,2.0,2550,6256,2.0,0.0,0.0,3.0,2550,0,1992,0,587000.0,Woodinville,98072,2550
3.0,2.0,1760,1146,3.0,0.0,0.0,3.0,1760,0,2014,0,615000.0,Seattle,98122,1760
3.0,2.0,1620,7330,1.0,0.0,0.0,4.0,1090,530,1974,0,459000.0,Kirkland,98034,1620
3.0,2.0,1790,12000,1.0,0.0,0.0,3.0,1040,750,1960,2012,243000.0,DesMoines,98198,1790
4.0,2.0,2780,9900,2.0,0.0,0.0,4.0,2780,0,1978,2000,660000.0,Sammamish,98074,2780
1.0,1.0,750,4000,1.0,0.0,0.0,3.0,750,0,1918,0,250000.0,Seattle,98136,750
3.0,1.0,960,6634,1.0,0.0,0.0,3.0,960,0,1952,2008,315000.0,Seattle,98125,960
3.0,2.0,2030,8880,1.0,0.0,0.0,3.0,1330,700,1963,2008,404000.0,Seattle,98108,2030
2.0,2.0,1380,1073,2.0,0.0,0.0,3.0,1140,240,2011,0,285000.0,Seattle,98126,1380
3.0,2.0,1720,5525,1.0,0.0,2.0,5.0,960,760,1941,0,500000.0,Seattle,98108,1720
2.0,1.0,1210,4800,1.0,0.0,0.0,3.0,1060,150,1950,2005,380000.0,Seattle,98108,1210
3.0,1.0,950,4250,1.5,0.0,0.0,5.0,950,0,1948,1985,469000.0,Seattle,98122,950
2.0,2.0,1710,4234,2.0,0.0,0.0,3.0,1330,380,1920,1979,405000.0,Seattle,98136,1710
2.0,2.0,1410,12282,1.5,0.0,0.0,5.0,1410,0,1909,1988,439900.0,Preston,98050,1410
4.0,2.0,2910,7631,2.0,0.0,2.0,3.0,2910,0,2006,0,525000.0,MapleValley,98038,2910
4.0,2.0,2220,7064,2.0,0.0,0.0,3.0,2220,0,1988,2000,580000.0,Issaquah,98029,2220
3.0,2.0,1380,4500,1.0,0.0,0.0,3.0,1380,0,2008,0,275000.0,MapleValley,98038,1380
3.0,2.0,1760,5000,1.0,0.0,0.0,5.0,960,800,1920,0,629000.0,Seattle,98199,1760
1.0,1.0,730,3000,1.0,0.0,0.0,3.0,730,0,1911,1979,395000.0,Seattle,98107,730
4.0,2.0,2460,5000,2.0,0.0,0.0,5.0,1620,840,1938,0,965000.0,Seattle,98112,2460
3.0,2.0,2160,6272,1.0,0.0,0.0,4.0,1390,770,1960,2001,820000.0,Seattle,98115,2160
4.0,2.0,1990,4600,1.5,0.0,2.0,4.0,1420,570,1932,1958,661000.0,Seattle,98126,1990
4.0,2.0,2710,5500,2.0,0.0,0.0,3.0,2710,0,1999,0,668500.0,Sammamish,98074,2710
3.0,2.0,2680,7836,2.0,0.0,0.0,3.0,2680,0,1990,2009,350000.0,Auburn,98092,2680
4.0,2.0,1850,7560,1.0,0.0,0.0,4.0,1540,310,1978,2000,250000.0,Kent,98032,1850
4.0,2.0,3190,7869,2.0,0.0,2.0,3.0,3190,0,2001,0,725995.0,Snoqualmie,98065,3190
3.0,2.0,2730,5832,2.0,0.0,0.0,3.0,2730,0,1998,2006,1000000.0,Bellevue,98005,2730
3.0,2.0,1840,9990,2.0,0.0,0.0,5.0,1840,0,1961,0,686000.0,Seattle,98177,1840
4.0,2.0,2720,10000,2.0,0.0,0.0,3.0,2720,0,1987,2000,665000.0,Sammamish,98074,2720
3.0,2.0,2290,3475,2.0,0.0,0.0,3.0,2290,0,2006,0,653000.0,Issaquah,98029,2290
2.0,1.0,990,4802,1.0,0.0,0.0,3.0,990,0,1947,2012,430000.0,Seattle,98117,990
2.0,2.0,1140,2980,2.0,0.0,0.0,3.0,1140,0,1988,2000,305000.0,Issaquah,98029,1140
4.0,2.0,1840,4337,2.0,0.0,0.0,4.0,1840,0,1917,0,809000.0,Seattle,98112,1840
2.0,1.0,1110,6800,1.0,0.0,0.0,5.0,1000,110,1947,0,440150.0,Seattle,98133,1110
4.0,2.0,2150,9070,2.0,0.0,0.0,4.0,2150,0,1985,0,615000.0,Redmond,98052,2150
3.0,2.0,2230,5750,2.0,0.0,0.0,3.0,2230,0,2003,0,1035000.0,Kirkland,98033,2230
2.0,1.0,1170,6000,1.0,0.0,0.0,4.0,970,200,1941,1998,455000.0,Seattle,98103,1170
3.0,2.0,1960,7200,1.0,0.0,0.0,4.0,980,980,1940,2001,635000.0,Seattle,98118,1960
3.0,2.0,2610,9002,2.0,0.0,0.0,3.0,2610,0,1988,2000,675000.0,Redmond,98052,2610
3.0,2.0,2130,8721,1.0,0.0,0.0,3.0,1570,560,1987,2000,316000.0,Kent,98031,2130
3.0,2.0,1670,5400,2.0,0.0,0.0,5.0,1670,0,1912,0,985000.0,Seattle,98112,1670
3.0,2.0,1890,7004,1.0,0.0,0.0,3.0,1290,600,1965,1993,465500.0,Seattle,98118,1890
3.0,1.0,950,13475,1.0,0.0,0.0,3.0,950,0,1950,2005,305000.0,Shoreline,98155,950
4.0,2.0,2430,14400,1.0,0.0,0.0,5.0,1670,760,1963,0,645000.0,Bellevue,98007,2430
4.0,2.0,2360,6000,1.0,0.0,0.0,5.0,1260,1100,1939,0,730000.0,Seattle,98199,2360
3.0,2.0,1510,8301,1.0,0.0,0.0,3.0,1510,0,1967,2011,366000.0,Kirkland,98034,1510
3.0,2.0,2080,4828,2.0,0.0,0.0,3.0,2080,0,2002,0,290000.0,Covington,98042,2080
3.0,2.0,1750,15500,1.0,0.0,0.0,3.0,1490,260,1982,0,472500.0,Sammamish,98075,1750
3.0,2.0,1810,4064,1.5,0.0,0.0,3.0,1810,0,1925,2002,550000.0,Seattle,98103,1810
4.0,2.0,1790,11875,1.0,0.0,0.0,4.0,1490,300,1969,0,410000.0,Issaquah,98027,1790
4.0,3.0,2340,11034,1.0,0.0,0.0,3.0,1720,620,1967,2011,440000.0,LakeForestPark,98155,2340
3.0,2.0,1690,9626,2.0,0.0,0.0,3.0,1690,0,1984,0,535000.0,Issaquah,98027,1690
4.0,2.0,2070,7476,2.0,0.0,0.0,3.0,2070,0,2003,0,300000.0,Auburn,98092,2070
3.0,2.0,2240,6396,2.0,0.0,0.0,3.0,2240,0,2002,0,432500.0,Snoqualmie,98065,2240
3.0,1.0,1010,7245,1.0,0.0,0.0,3.0,1010,0,1969,2010,199950.0,FederalWay,98003,1010
3.0,2.0,1120,6900,1.0,0.0,0.0,5.0,1120,0,1956,0,439800.0,Bellevue,98007,1120
3.0,2.0,1990,5650,1.0,0.0,1.0,3.0,1320,670,1963,2008,345000.0,Seattle,98178,1990
3.0,1.0,1450,8820,1.0,0.0,0.0,3.0,1050,400,1958,2004,274950.0,Tukwila,98168,1450
4.0,2.0,1920,8497,2.0,0.0,0.0,3.0,1920,0,1998,2006,270000.0,Auburn,98092,1920
2.0,2.0,1175,1366,2.0,0.0,0.0,3.0,740,435,2005,0,342000.0,Seattle,98103,1175
3.0,2.0,1320,13200,1.0,0.0,0.0,3.0,1320,0,1970,2014,327000.0,Renton,98059,1320
5.0,2.0,3990,3839,1.0,0.0,0.0,4.0,1990,2000,1962,0,610000.0,Seattle,98112,3990
2.0,1.0,1140,5720,1.0,0.0,0.0,3.0,850,290,1947,2012,455000.0,Seattle,98115,1140
4.0,2.0,1720,4240,1.5,0.0,0.0,4.0,1460,260,1925,1968,540000.0,Seattle,98144,1720
4.0,3.0,2150,9915,1.0,0.0,0.0,5.0,1240,910,1976,0,411000.0,Newcastle,98056,2150
3.0,2.0,1790,8203,1.5,0.0,1.0,3.0,1790,0,1910,2006,544000.0,Seattle,98116,1790
2.0,2.0,2210,6327,1.0,0.0,0.0,3.0,2210,0,2003,0,802000.0,Redmond,98053,2210
3.0,3.0,2180,7519,1.0,0.0,0.0,4.0,1310,870,1981,0,568500.0,Redmond,98052,2180
3.0,2.0,1950,3600,2.0,0.0,0.0,3.0,1950,0,2010,0,298000.0,MapleValley,98038,1950
3.0,2.0,1495,936,3.0,0.0,0.0,3.0,1405,90,2006,0,400000.0,Seattle,98144,1495
3.0,2.0,1660,6000,1.0,0.0,0.0,3.0,1110,550,1979,2014,425000.0,Seattle,98122,1660
3.0,2.0,1950,8130,2.0,0.0,0.0,4.0,1950,0,1990,0,328500.0,Kent,98042,1950
5.0,3.0,2550,5040,1.5,0.0,0.0,5.0,2550,0,1902,0,650000.0,Seattle,98122,2550
3.0,2.0,1370,3850,1.0,0.0,0.0,5.0,770,600,1911,1988,850000.0,Seattle,98112,1370
4.0,2.0,2200,4000,2.0,0.0,0.0,5.0,1430,770,1908,0,930000.0,Seattle,98119,2200
3.0,2.0,1250,6041,1.5,0.0,0.0,5.0,1250,0,1942,0,530000.0,Seattle,98115,1250
4.0,2.0,2220,8872,1.0,0.0,0.0,4.0,1110,1110,1961,2001,495000.0,Bellevue,98006,2220
3.0,2.0,1620,4200,1.0,0.0,0.0,5.0,830,790,1945,0,500000.0,Seattle,98115,1620
4.0,2.0,3030,9687,2.0,0.0,0.0,3.0,2020,1010,1998,2006,471000.0,NorthBend,98045,3030
3.0,1.0,1030,9120,1.0,0.0,0.0,3.0,1030,0,1961,2004,223000.0,Kent,98032,1030
3.0,2.0,2190,4882,2.0,0.0,0.0,3.0,2190,0,1999,0,503000.0,LakeForestPark,98155,2190
3.0,2.0,1440,5600,1.0,0.0,0.0,4.0,720,720,1942,2007,230000.0,Renton,98056,1440
4.0,2.0,2170,9600,1.0,0.0,0.0,3.0,1460,710,1980,0,550000.0,Redmond,98052,2170
4.0,4.0,2930,3200,1.5,0.0,0.0,5.0,2130,800,1925,0,1100000.0,Seattle,98119,2930
3.0,2.0,1180,9048,1.0,0.0,0.0,3.0,1180,0,1960,2012,193000.0,Burien,98148,1180
3.0,2.0,1660,8797,1.0,0.0,0.0,4.0,1660,0,1956,0,712500.0,Bellevue,98004,1660
3.0,3.0,2390,9313,1.0,0.0,0.0,5.0,1390,1000,1942,0,689800.0,Seattle,98133,2390
3.0,2.0,1360,5120,1.5,0.0,0.0,4.0,910,450,1924,0,430000.0,Seattle,98116,1360
3.0,2.0,1840,3500,1.5,0.0,0.0,5.0,1540,300,1910,0,785200.0,Seattle,98122,1840
4.0,4.0,4130,12320,2.0,0.0,0.0,3.0,4130,0,2001,0,1070000.0,Newcastle,98059,4130
5.0,4.0,3490,9680,2.0,0.0,4.0,3.0,2460,1030,1980,0,941500.0,Shoreline,98177,3490
4.0,2.0,1830,5175,2.0,0.0,0.0,3.0,1830,0,2003,0,312000.0,MapleValley,98038,1830
4.0,3.0,1550,4000,1.5,0.0,0.0,3.0,1550,0,1930,1997,835000.0,Seattle,98105,1550
3.0,2.0,2050,9000,1.0,0.0,0.0,4.0,2050,0,1951,1999,713250.0,MercerIsland,98040,2050
2.0,1.0,1230,6600,1.0,0.0,0.0,3.0,1130,100,1906,2014,440000.0,Seattle,98118,1230
4.0,2.0,3150,5886,2.0,0.0,0.0,3.0,3150,0,2014,0,580135.0,Renton,98059,3150
3.0,2.0,1350,3068,2.0,0.0,0.0,3.0,1350,0,1991,0,613000.0,Seattle,98122,1350
3.0,2.0,1530,8700,1.0,0.0,0.0,4.0,1530,0,1970,0,235000.0,Renton,98055,1530
3.0,2.0,2290,2798,3.0,0.0,0.0,4.0,2290,0,1953,1983,660000.0,Seattle,98102,2290
2.0,2.0,1480,15641,1.0,0.0,0.0,4.0,1480,0,1940,2001,280000.0,Seattle,98146,1480
3.0,2.0,1970,10270,1.0,0.0,0.0,4.0,1970,0,1966,0,268000.0,Kent,98032,1970
2.0,1.0,720,4840,1.0,0.0,0.0,4.0,720,0,1947,1988,235000.0,Seattle,98126,720
3.0,2.0,1080,7236,1.0,0.0,0.0,5.0,1080,0,1947,0,390000.0,Seattle,98125,1080
5.0,3.0,2040,7488,1.0,0.0,0.0,4.0,1200,840,1969,0,449500.0,Kirkland,98034,2040
3.0,1.0,1320,8220,1.0,0.0,0.0,3.0,1320,0,1959,1989,150000.0,DesMoines,98198,1320
3.0,2.0,2140,4923,1.0,0.0,0.0,4.0,1070,1070,1928,0,710000.0,Seattle,98103,2140
3.0,2.0,1660,9600,1.0,0.0,0.0,3.0,1380,280,1981,2013,420000.0,Bothell,98011,1660
3.0,2.0,1540,5338,1.0,0.0,0.0,5.0,770,770,1954,0,312000.0,Seattle,98115,1540
3.0,2.0,1880,10758,1.0,0.0,0.0,5.0,940,940,1952,1998,320000.0,Renton,98059,1880
3.0,1.0,1250,15603,1.0,0.0,0.0,4.0,1250,0,1959,0,235000.0,Renton,98056,1250
3.0,2.0,1810,3000,1.5,0.0,0.0,4.0,1810,0,1903,0,545000.0,Seattle,98107,1810
3.0,2.0,2370,11172,2.0,0.0,0.0,3.0,2370,0,1993,0,640000.0,Newcastle,98056,2370
3.0,2.0,1970,4036,2.0,0.0,0.0,4.0,1970,0,2003,0,432000.0,Snoqualmie,98065,1970
3.0,2.0,2110,4099,2.0,0.0,0.0,3.0,2110,0,2001,0,548000.0,Woodinville,98072,2110
4.0,2.0,3720,12384,1.0,0.0,2.0,5.0,1860,1860,1970,0,875000.0,Sammamish,98075,3720
2.0,2.0,1370,5125,1.0,0.0,0.0,5.0,1370,0,1944,0,409950.0,Seattle,98103,1370
4.0,2.0,2961,12146,2.0,0.0,0.0,3.0,2961,0,1998,2006,695000.0,Sammamish,98075,2961
3.0,2.0,2090,12112,2.0,0.0,0.0,3.0,2090,0,1983,2009,562100.0,Redmond,98052,2090
3.0,2.0,2600,7210,2.0,0.0,0.0,3.0,2600,0,1989,0,475000.0,Renton,98059,2600
3.0,2.0,1870,9000,1.0,0.0,0.0,3.0,1440,430,1978,0,425000.0,Bothell,98011,1870
4.0,2.0,2620,9873,2.0,0.0,0.0,3.0,2620,0,1987,2000,600000.0,Issaquah,98075,2620
3.0,2.0,1340,16480,1.0,0.0,0.0,4.0,1340,0,1968,0,239000.0,Kent,98042,1340
2.0,1.0,1170,10621,1.0,0.0,0.0,3.0,1170,0,1963,2008,295000.0,NorthBend,98045,1170
3.0,2.0,2000,10182,1.0,0.0,0.0,5.0,1400,600,1963,0,560000.0,Kirkland,98033,2000
5.0,2.0,2070,12000,1.0,0.0,0.0,4.0,1340,730,1967,0,613000.0,Bellevue,98008,2070
4.0,3.0,4590,9150,2.0,0.0,0.0,3.0,3490,1100,1981,2013,960000.0,Seattle,98177,4590
5.0,1.0,2550,4623,2.5,0.0,0.0,4.0,2550,0,1905,0,847000.0,Seattle,98122,2550
3.0,1.0,1060,9600,1.0,0.0,0.0,4.0,1060,0,1962,0,206000.0,FederalWay,98023,1060
2.0,2.0,1220,5000,1.0,0.0,0.0,5.0,860,360,1921,0,253000.0,Renton,98057,1220
4.0,2.0,1790,7203,1.0,0.0,0.0,4.0,1110,680,1973,0,430000.0,LakeForestPark,98155,1790
3.0,2.0,2060,4040,1.0,0.0,0.0,4.0,1120,940,1947,1988,605000.0,Seattle,98103,2060
2.0,2.0,1140,1182,3.0,0.0,0.0,3.0,1140,0,2007,0,425000.0,Seattle,98107,1140
4.0,2.0,2870,12648,2.0,0.0,0.0,4.0,2870,0,1986,0,720000.0,Issaquah,98029,2870
3.0,1.0,1110,7962,1.0,0.0,0.0,3.0,1110,0,1962,2003,210000.0,Seattle,98146,1110
2.0,1.0,940,5375,1.0,0.0,0.0,4.0,940,0,1952,0,234000.0,DesMoines,98198,940
3.0,2.0,2880,18296,1.0,0.0,0.0,3.0,1580,1300,1958,2004,285000.0,Tukwila,98168,2880
3.0,2.0,1200,4800,1.0,0.0,0.0,4.0,1200,0,1962,0,400000.0,Bellevue,98007,1200
3.0,1.0,1030,4958,1.0,0.0,0.0,5.0,1030,0,1952,1998,718000.0,Seattle,98105,1030
2.0,2.0,1240,2689,2.0,0.0,0.0,3.0,1240,0,1986,0,174500.0,FederalWay,98003,1240
3.0,2.0,1200,9566,1.0,0.0,0.0,3.0,1200,0,1995,0,222400.0,Pacific,98047,1200
3.0,3.0,2780,4002,2.0,0.0,0.0,3.0,2780,0,2009,0,402500.0,Duvall,98019,2780
3.0,2.0,1765,7652,2.0,0.0,0.0,3.0,1765,0,1996,0,250000.0,FederalWay,98003,1765
4.0,2.0,1960,14242,1.0,0.0,1.0,4.0,1290,670,1958,1972,600000.0,Burien,98146,1960
2.0,2.0,2680,11214,1.0,0.0,0.0,3.0,2680,0,2006,0,930000.0,Redmond,98053,2680
3.0,2.0,1410,7622,1.0,0.0,0.0,4.0,1410,0,1983,0,272500.0,Renton,98058,1410
4.0,2.0,2240,3712,2.0,0.0,0.0,3.0,2240,0,2014,0,363990.0,MapleValley,98038,2240
4.0,3.0,3120,7644,2.0,0.0,0.0,3.0,3120,0,2010,0,575000.0,Snoqualmie,98065,3120
3.0,2.0,1450,4706,2.0,0.0,0.0,3.0,1450,0,2009,0,400000.0,Kenmore,98028,1450
5.0,3.0,2481,4045,2.0,0.0,0.0,3.0,2481,0,2014,0,309000.0,Auburn,98001,2481
3.0,2.0,1250,7500,1.0,0.0,0.0,5.0,1250,0,1942,0,390000.0,Seattle,98146,1250
1.0,1.0,560,12120,1.0,0.0,0.0,3.0,560,0,1967,2011,299000.0,Carnation,98014,560
4.0,2.0,2200,7475,1.0,0.0,0.0,5.0,1100,1100,1955,0,375000.0,Seattle,98118,2200
3.0,2.0,1460,10584,1.0,0.0,0.0,3.0,990,470,1997,0,240500.0,Seattle,98168,1460
3.0,2.0,1650,9380,1.0,0.0,0.0,5.0,1130,520,1978,0,320000.0,Renton,98058,1650
3.0,2.0,2080,4252,1.5,0.0,0.0,3.0,1550,530,2003,0,270000.0,Kent,98042,2080
3.0,1.0,1070,7140,1.0,0.0,0.0,3.0,1070,0,1989,0,327500.0,Seattle,98118,1070
3.0,2.0,2190,12626,2.0,0.0,0.0,4.0,2190,0,1978,2000,340000.0,Kent,98042,2190
3.0,2.0,2060,15837,1.5,0.0,0.0,3.0,2060,0,1903,2005,200000.0,Renton,98057,2060
3.0,2.0,2640,8000,1.0,0.0,3.0,4.0,1320,1320,1960,2001,1025000.0,MercerIsland,98040,2640
3.0,2.0,1720,8755,1.0,0.0,0.0,3.0,1000,720,1983,2009,275000.0,FederalWay,98023,1720
5.0,4.0,3880,13885,2.0,0.0,3.0,4.0,2540,1340,1979,0,1126000.0,Bellevue,98006,3880
2.0,1.0,960,4920,1.0,0.0,0.0,3.0,960,0,1942,1999,280000.0,Seattle,98117,960
3.0,2.0,2090,4725,2.0,0.0,0.0,3.0,1610,480,1947,2013,865000.0,Seattle,98199,2090
3.0,2.0,1820,4910,2.0,0.0,0.0,3.0,1820,0,1993,0,532000.0,Issaquah,98029,1820
4.0,2.0,2310,8030,2.0,0.0,0.0,3.0,2310,0,1978,0,364950.0,Duvall,98019,2310
3.0,1.0,920,14400,1.0,0.0,0.0,4.0,920,0,1977,0,212500.0,Auburn,98001,920
1.0,1.0,790,13062,1.0,0.0,0.0,3.0,790,0,1942,1999,135000.0,Seattle,98168,790
2.0,2.0,1500,6800,1.0,0.0,0.0,4.0,910,590,1942,1982,437000.0,Seattle,98117,1500
3.0,1.0,1240,11108,1.0,0.0,0.0,4.0,1240,0,1952,0,390000.0,NormandyPark,98166,1240
3.0,1.0,1170,11000,1.0,0.0,0.0,2.0,1170,0,1980,0,119500.0,Duvall,98019,1170
4.0,2.0,2700,9320,2.0,0.0,0.0,4.0,2700,0,1994,0,837500.0,Kirkland,98033,2700
4.0,2.0,1650,7800,1.0,0.0,0.0,3.0,1650,0,1968,1997,327500.0,Renton,98058,1650
2.0,1.0,670,2378,1.0,0.0,0.0,3.0,670,0,1919,2001,175000.0,Seattle,98126,670
3.0,2.0,1670,7757,1.0,0.0,0.0,3.0,1670,0,1992,0,289950.0,Kent,98030,1670
3.0,2.0,1530,10731,1.0,0.0,0.0,3.0,1530,0,1986,0,400000.0,Kenmore,98028,1530
3.0,2.0,1500,7615,1.0,0.0,0.0,3.0,1150,350,1984,0,219950.0,FederalWay,98023,1500
4.0,2.0,1720,7200,1.0,0.0,0.0,3.0,1220,500,1974,0,161700.0,FederalWay,98023,1720
5.0,3.0,2920,11440,2.0,0.0,0.0,3.0,2920,0,2003,0,500000.0,Shoreline,98133,2920
3.0,1.0,910,4500,1.0,0.0,0.0,3.0,910,0,1948,1994,465000.0,Seattle,98117,910
3.0,1.0,1050,4160,1.0,0.0,0.0,4.0,1050,0,1925,1968,540000.0,Seattle,98115,1050
3.0,1.0,1210,7440,1.0,0.0,0.0,3.0,1210,0,1949,1998,324950.0,Shoreline,98155,1210
5.0,2.0,2650,11455,1.0,0.0,0.0,3.0,1400,1250,1961,2004,565000.0,Bellevue,98008,2650
3.0,2.0,1990,3990,1.0,0.0,0.0,5.0,1130,860,1912,0,760500.0,Seattle,98103,1990
5.0,3.0,2660,8737,1.0,0.0,4.0,5.0,1470,1190,1969,0,1100000.0,Bellevue,98006,2660
4.0,2.0,4060,9734,1.0,0.0,4.0,3.0,2150,1910,1977,2004,603500.0,Kenmore,98028,4060
6.0,3.0,2630,16411,1.0,0.0,0.0,4.0,1650,980,1974,0,583000.0,Redmond,98052,2630
2.0,1.0,770,8149,1.0,0.0,0.0,5.0,770,0,1948,1985,275000.0,Shoreline,98155,770
4.0,3.0,3790,10669,2.0,0.0,0.0,3.0,3790,0,1999,0,875000.0,Sammamish,98075,3790
4.0,3.0,2540,7210,1.0,0.0,0.0,4.0,1600,940,1979,0,335000.0,Renton,98058,2540
4.0,2.0,2500,8500,1.0,0.0,0.0,4.0,1600,900,1978,2000,646000.0,Bellevue,98006,2500
4.0,2.0,2150,7303,2.0,0.0,0.0,3.0,2150,0,2005,0,392500.0,Renton,98056,2150
3.0,2.0,1670,9600,1.0,0.0,0.0,5.0,1670,0,1961,0,785000.0,MercerIsland,98040,1670
3.0,2.0,1800,12669,1.0,0.0,0.0,3.0,1800,0,1956,1990,470000.0,Kirkland,98033,1800
3.0,2.0,2070,12708,2.0,0.0,0.0,3.0,2070,0,1996,0,560000.0,Newcastle,98056,2070
2.0,1.0,830,2820,1.0,0.0,0.0,4.0,830,0,1920,0,519000.0,Seattle,98103,830
3.0,2.0,2370,9619,1.0,0.0,0.0,4.0,1650,720,1973,0,746000.0,Redmond,98052,2370
3.0,1.0,1010,5400,1.0,0.0,0.0,3.0,1010,0,1959,1989,317000.0,Seattle,98144,1010
3.0,2.0,1420,4500,1.0,0.0,0.0,3.0,1420,0,1959,1989,371000.0,Seattle,98103,1420
4.0,2.0,2120,8701,1.5,0.0,0.0,4.0,2120,0,1960,2001,250000.0,DesMoines,98198,2120
4.0,2.0,2020,7029,1.0,0.0,0.0,4.0,1430,590,1979,0,532000.0,Redmond,98052,2020
3.0,2.0,1520,2208,2.0,0.0,0.0,3.0,1040,480,2007,0,499950.0,Seattle,98119,1520
2.0,1.0,820,6250,1.0,0.0,0.0,4.0,820,0,1922,0,375000.0,Seattle,98136,820
3.0,2.0,1690,1553,2.5,0.0,0.0,3.0,1690,0,2007,0,640000.0,Seattle,98199,1690
3.0,2.0,2260,11305,1.0,0.0,0.0,3.0,1130,1130,1986,0,400000.0,Renton,98055,2260
3.0,2.0,1830,7897,1.0,0.0,0.0,4.0,1290,540,1986,0,572000.0,Redmond,98052,1830
3.0,2.0,1350,11150,1.0,0.0,0.0,3.0,1110,240,1995,0,310000.0,NorthBend,98045,1350
5.0,4.0,3280,4000,2.0,0.0,0.0,3.0,2440,840,2003,0,989000.0,Seattle,98117,3280
4.0,2.0,2770,8642,2.0,0.0,0.0,4.0,2770,0,1987,0,907500.0,Bellevue,98007,2770
4.0,2.0,2460,5091,2.0,0.0,0.0,3.0,2460,0,2003,0,427500.0,Renton,98058,2460
2.0,1.0,1250,8100,1.0,0.0,0.0,4.0,1250,0,1947,1988,365000.0,Seattle,98125,1250
3.0,2.0,1710,7225,2.0,0.0,0.0,4.0,1710,0,1988,0,250500.0,FederalWay,98023,1710
3.0,2.0,1840,5101,1.0,0.0,0.0,5.0,1040,800,1952,1998,411715.0,Seattle,98108,1840
4.0,2.0,2000,5962,2.0,0.0,0.0,3.0,2000,0,1999,0,415000.0,Shoreline,98133,2000
1.0,1.0,650,15364,1.0,0.0,0.0,4.0,650,0,1967,0,129000.0,Kent,98042,650
3.0,2.0,1020,9072,1.0,0.0,0.0,3.0,920,100,1930,1997,489000.0,Seattle,98115,1020
2.0,1.0,1500,18540,1.0,0.0,0.0,3.0,1500,0,1950,2005,170000.0,Tukwila,98168,1500
3.0,2.0,2060,4399,2.0,0.0,0.0,3.0,2060,0,2007,0,418500.0,Snoqualmie,98065,2060
2.0,2.0,1650,4000,1.0,0.0,0.0,4.0,950,700,1947,1988,355000.0,Seattle,98108,1650
3.0,3.0,1540,704,3.0,0.0,0.0,3.0,1540,0,2011,0,742000.0,Seattle,98122,1540
3.0,2.0,2080,5244,1.0,0.0,0.0,3.0,1190,890,1959,1989,399950.0,Seattle,98125,2080
3.0,2.0,2430,5500,2.0,0.0,0.0,3.0,1810,620,1989,0,791000.0,Kirkland,98033,2430
5.0,2.0,1750,10284,1.0,0.0,0.0,4.0,1750,0,1943,0,190000.0,Renton,98056,1750
3.0,2.0,1710,2300,2.0,0.0,0.0,3.0,1570,140,2005,0,539000.0,Redmond,98052,1710
5.0,2.0,2730,17240,1.0,0.0,0.0,5.0,1660,1070,1958,0,545000.0,Kenmore,98028,2730
3.0,2.0,2437,5136,2.0,0.0,0.0,3.0,2437,0,2011,0,285000.0,Auburn,98002,2437
4.0,2.0,3290,6203,2.0,0.0,0.0,3.0,3290,0,2008,0,648000.0,Snoqualmie,98065,3290
3.0,2.0,1630,7599,1.0,0.0,0.0,3.0,1630,0,2006,0,767450.0,Seattle,98117,1630
4.0,3.0,4410,5104,2.0,0.0,0.0,3.0,3400,1010,2006,0,765000.0,Snoqualmie,98065,4410
3.0,2.0,1780,1487,3.0,0.0,0.0,3.0,1600,180,2006,0,586500.0,Seattle,98103,1780
3.0,3.0,1540,1487,2.0,0.0,0.0,3.0,1540,0,2011,0,520000.0,Issaquah,98029,1540
3.0,2.0,1420,1189,3.0,0.0,0.0,3.0,1420,0,2006,0,455000.0,Seattle,98103,1420
3.0,2.0,2680,9750,1.0,0.0,0.0,4.0,1610,1070,1979,0,653000.0,Kirkland,98034,2680
3.0,2.0,1750,9750,1.0,0.0,0.0,3.0,1350,400,1961,2004,279950.0,DesMoines,98198,1750
3.0,2.0,2170,4912,2.0,0.0,0.0,3.0,2170,0,2003,0,449950.0,Kenmore,98028,2170
3.0,3.0,2390,9966,1.0,0.0,0.0,5.0,1360,1030,1977,0,565000.0,Bellevue,98006,2390
4.0,2.0,2400,5350,1.5,0.0,0.0,4.0,1460,940,1929,0,620000.0,Seattle,98117,2400
3.0,1.0,1690,4250,1.0,0.0,0.0,3.0,1020,670,1967,2011,269000.0,Seattle,98178,1690
3.0,4.0,3250,6000,2.0,0.0,0.0,3.0,2500,750,2001,0,875000.0,Seattle,98136,3250
4.0,3.0,2440,15349,2.0,0.0,1.0,4.0,2440,0,1957,2001,425000.0,DesMoines,98198,2440
3.0,2.0,1290,3870,1.0,0.0,0.0,5.0,1290,0,1916,0,647500.0,Seattle,98144,1290
4.0,1.0,2000,4676,1.5,0.0,0.0,3.0,1250,750,1916,1986,450000.0,Seattle,98118,2000
4.0,2.0,2340,3784,2.0,0.0,0.0,3.0,2340,0,2008,0,445000.0,Seattle,98106,2340
4.0,2.0,2210,7665,2.0,0.0,0.0,4.0,2210,0,1968,0,530000.0,Bellevue,98006,2210
5.0,2.0,2920,5568,2.0,0.0,0.0,3.0,2320,600,1906,2014,875000.0,Seattle,98112,2920
3.0,4.0,3590,6402,2.0,0.0,0.0,3.0,3590,0,1999,0,798000.0,Sammamish,98074,3590
4.0,2.0,1910,5000,2.0,0.0,0.0,3.0,1910,0,2005,0,297500.0,MapleValley,98038,1910
5.0,3.0,2440,4750,1.0,0.0,0.0,3.0,1450,990,2006,0,495000.0,Seattle,98108,2440
4.0,2.0,1330,8400,1.5,0.0,0.0,3.0,1330,0,1962,2003,540000.0,Bellevue,98005,1330
5.0,5.0,5180,17811,2.0,0.0,2.0,3.0,4070,1110,2001,0,1075000.0,Snoqualmie,98065,5180
4.0,2.0,1920,10403,1.0,0.0,0.0,3.0,1370,550,1959,1989,210000.0,FederalWay,98023,1920
2.0,1.0,970,3400,1.0,0.0,0.0,3.0,970,0,1924,2011,546000.0,Seattle,98109,970
5.0,2.0,2490,7666,1.0,0.0,0.0,4.0,1490,1000,1989,0,292000.0,Kent,98031,2490
3.0,2.0,1680,8424,1.0,0.0,0.0,3.0,1680,0,1993,0,289000.0,Enumclaw,98022,1680
3.0,1.0,1150,4825,1.0,0.0,0.0,4.0,1150,0,1957,2001,240000.0,Issaquah,98027,1150
4.0,3.0,1980,7931,1.0,0.0,0.0,4.0,1160,820,1983,0,395000.0,Shoreline,98133,1980
4.0,2.0,2070,13084,1.0,0.0,0.0,4.0,1700,370,1967,0,795000.0,MercerIsland,98040,2070
4.0,3.0,2420,10962,1.0,0.0,0.0,3.0,1530,890,1977,2004,725000.0,Bellevue,98007,2420
4.0,2.0,2610,4781,2.0,0.0,0.0,3.0,2610,0,2009,0,335000.0,Auburn,98001,2610
4.0,4.0,2810,10840,2.0,0.0,2.0,4.0,2070,740,1994,0,492000.0,NorthBend,98045,2810
3.0,2.0,1510,10384,1.0,0.0,0.0,2.0,1030,480,1976,0,250000.0,Woodinville,98077,1510
3.0,2.0,1910,4800,1.0,0.0,0.0,3.0,1080,830,1959,1989,700000.0,Seattle,98103,1910
4.0,3.0,2020,10720,1.0,0.0,0.0,4.0,1420,600,1976,1992,555000.0,Redmond,98052,2020
3.0,2.0,2340,4206,1.0,0.0,0.0,5.0,1170,1170,1917,0,640000.0,Seattle,98144,2340
3.0,2.0,1463,868,3.0,0.0,0.0,3.0,1463,0,2003,0,390000.0,Seattle,98115,1463
3.0,1.0,1430,3840,1.0,0.0,0.0,3.0,950,480,1945,2010,466500.0,Seattle,98117,1430
3.0,2.0,1180,12324,1.0,0.0,0.0,3.0,800,380,1981,2013,372500.0,Sammamish,98074,1180
3.0,2.0,1610,6176,2.0,0.0,0.0,3.0,1610,0,1994,0,255000.0,Kent,98030,1610
3.0,2.0,1480,14250,2.0,0.0,0.0,3.0,1480,0,1996,0,466800.0,Kirkland,98033,1480
3.0,2.0,2670,10338,2.0,0.0,0.0,3.0,2670,0,1987,2000,749000.0,Bellevue,98007,2670
2.0,1.0,920,4095,1.0,0.0,0.0,4.0,920,0,1914,1945,356000.0,Seattle,98118,920
3.0,1.0,1150,19200,1.0,0.0,0.0,4.0,1150,0,1908,0,165000.0,Auburn,98001,1150
2.0,1.0,1190,7408,1.0,0.0,0.0,3.0,830,360,1941,1994,229000.0,Seattle,98168,1190
3.0,2.0,2370,12753,2.0,0.0,0.0,3.0,2370,0,2001,0,499950.0,Duvall,98019,2370
4.0,2.0,1660,3800,1.5,0.0,0.0,3.0,1660,0,1926,2003,619000.0,Seattle,98115,1660
3.0,2.0,1480,8381,1.0,0.0,0.0,4.0,1480,0,1968,0,547000.0,Seattle,98125,1480
4.0,2.0,2390,6426,2.0,0.0,0.0,3.0,2390,0,1999,0,359800.0,Auburn,98092,2390
3.0,4.0,1690,1432,2.0,0.0,0.0,3.0,1360,330,2008,0,499000.0,Seattle,98199,1690
3.0,1.0,1010,7560,1.0,0.0,0.0,3.0,1010,0,1958,2004,189000.0,Renton,98058,1010
4.0,4.0,3500,8547,2.0,0.0,0.0,3.0,2500,1000,1994,0,799000.0,Bellevue,98006,3500
4.0,3.0,2330,7642,1.0,0.0,0.0,3.0,1800,530,1990,2009,257000.0,FederalWay,98023,2330
3.0,2.0,1890,9450,1.0,0.0,0.0,3.0,1090,800,1957,2000,270000.0,Burien,98146,1890
4.0,2.0,2000,6032,1.0,0.0,2.0,3.0,1300,700,1959,1989,453500.0,Seattle,98146,2000
3.0,1.0,1130,10650,1.0,0.0,0.0,3.0,1130,0,1954,2005,237000.0,SeaTac,98188,1130
4.0,2.0,1670,9886,1.0,0.0,0.0,5.0,1670,0,1947,0,456000.0,Seattle,98125,1670
3.0,2.0,1170,5360,1.0,0.0,0.0,3.0,1170,0,1919,2001,335000.0,Seattle,98106,1170
4.0,2.0,2100,4237,2.0,0.0,0.0,3.0,2100,0,2006,0,268500.0,Kent,98031,2100
3.0,2.0,1710,11500,1.0,0.0,0.0,3.0,1210,500,1978,0,385000.0,Kenmore,98028,1710
4.0,3.0,2420,5773,2.0,0.0,0.0,3.0,2420,0,2005,0,376000.0,MapleValley,98038,2420
4.0,2.0,1370,4000,2.0,0.0,0.0,3.0,1370,0,1951,1994,605004.0,Seattle,98199,1370
4.0,2.0,2660,3900,1.5,0.0,0.0,4.0,1480,1180,1923,0,886000.0,Seattle,98112,2660
4.0,2.0,2260,3713,2.0,0.0,0.0,3.0,2260,0,2003,0,560000.0,Kirkland,98034,2260
3.0,1.0,1500,13500,1.0,0.0,0.0,4.0,1500,0,1968,0,270000.0,Renton,98059,1500
4.0,2.0,2658,3960,2.0,0.0,0.0,3.0,2658,0,2014,0,411605.0,Auburn,98092,2658
4.0,2.0,2700,5150,2.0,0.0,0.0,3.0,2700,0,2007,0,550000.0,Renton,98059,2700
3.0,2.0,1530,1245,2.0,0.0,0.0,3.0,1050,480,2014,0,465000.0,Seattle,98122,1530
3.0,2.0,1480,1485,2.0,0.0,0.0,3.0,1280,200,2007,0,584000.0,Seattle,98102,1480
3.0,3.0,1390,1080,2.0,0.0,0.0,3.0,1140,250,2006,0,275000.0,Seattle,98118,1390
3.0,2.0,1660,3990,2.0,0.0,0.0,3.0,1660,0,2009,0,324500.0,Seattle,98118,1660
3.0,2.0,2050,4185,2.0,0.0,0.0,3.0,2050,0,2011,0,700000.0,Seattle,98117,2050
4.0,1.0,1550,7740,1.5,0.0,0.0,3.0,1550,0,1954,2005,385200.0,Seattle,98126,1550
4.0,2.0,1900,8600,1.0,0.0,0.0,4.0,1900,0,1975,0,270000.0,FederalWay,98023,1900
2.0,2.0,1490,4080,1.0,0.0,0.0,3.0,930,560,1956,2001,389250.0,Seattle,98126,1490
3.0,2.0,1750,12500,1.0,0.0,0.0,3.0,1150,600,1954,2005,315000.0,FallCity,98024,1750
4.0,2.0,2040,6034,2.0,0.0,0.0,3.0,2040,0,1990,2009,545000.0,Seattle,98115,2040
3.0,2.0,1900,5000,1.5,0.0,0.0,3.0,1640,260,1926,2003,550000.0,Seattle,98115,1900
3.0,2.0,1910,12596,1.0,0.0,0.0,3.0,1340,570,1977,2004,415000.0,Woodinville,98072,1910
3.0,1.0,1560,14333,1.0,0.0,0.0,4.0,1560,0,1953,1983,387500.0,NormandyPark,98166,1560
3.0,2.0,1470,6250,1.0,0.0,3.0,4.0,1070,400,1939,1989,432000.0,LakeForestPark,98155,1470
3.0,2.0,2700,9994,1.0,0.0,3.0,4.0,1350,1350,1959,0,402000.0,DesMoines,98198,2700
4.0,3.0,3450,11240,2.0,0.0,3.0,4.0,2430,1020,1960,2001,1035000.0,Burien,98166,3450
3.0,2.0,1970,9600,1.0,0.0,0.0,4.0,1300,670,1967,0,294700.0,FederalWay,98003,1970
3.0,2.0,2670,12187,2.0,0.0,0.0,3.0,2670,0,1986,0,744000.0,Redmond,98052,2670
3.0,2.0,2550,13458,2.0,0.0,0.0,3.0,2550,0,1990,2009,715000.0,Bellevue,98006,2550
4.0,1.0,1720,4011,1.5,0.0,0.0,4.0,1720,0,1904,0,500000.0,Seattle,98107,1720
4.0,2.0,2840,9354,2.0,0.0,0.0,3.0,2840,0,1990,2009,650000.0,Sammamish,98074,2840
3.0,2.0,1480,7040,1.0,0.0,0.0,3.0,1480,0,1974,0,510000.0,Kirkland,98033,1480
5.0,3.0,2440,8000,1.0,0.0,0.0,4.0,1240,1200,1972,0,525000.0,Kirkland,98034,2440
4.0,3.0,2880,5750,1.5,0.0,0.0,5.0,1710,1170,1928,1970,920000.0,Seattle,98116,2880
2.0,1.0,1730,9610,1.0,0.0,0.0,3.0,1380,350,1962,2003,200000.0,Auburn,98001,1730
2.0,1.0,1260,4080,1.5,0.0,0.0,5.0,1260,0,1926,0,435000.0,Seattle,98115,1260
4.0,2.0,2230,9900,1.5,0.0,0.0,5.0,2230,0,1959,0,809950.0,Bellevue,98005,2230
3.0,2.0,2030,2805,2.0,0.0,0.0,3.0,1720,310,2001,0,471000.0,Issaquah,98027,2030
2.0,1.0,810,4800,1.0,0.0,0.0,3.0,810,0,1948,1994,253500.0,Seattle,98126,810
3.0,1.0,1840,8100,1.0,0.0,0.0,4.0,920,920,1953,1983,185000.0,Burien,98166,1840
2.0,2.0,2280,6815,1.0,0.0,0.0,3.0,2280,0,2002,0,835000.0,Redmond,98053,2280
4.0,2.0,2630,6326,2.0,0.0,0.0,3.0,2630,0,2008,0,589500.0,Snoqualmie,98065,2630
3.0,2.0,1020,7020,1.5,0.0,0.0,4.0,1020,0,1953,1983,360000.0,Shoreline,98155,1020
4.0,2.0,1990,2175,2.0,0.0,0.0,3.0,1680,310,2005,0,595000.0,Seattle,98107,1990
4.0,2.0,2680,15508,2.0,0.0,0.0,3.0,2680,0,1999,0,300000.0,FederalWay,98023,2680
3.0,2.0,1980,3300,1.5,0.0,0.0,4.0,1140,840,1926,1993,660000.0,Seattle,98115,1980
3.0,2.0,2400,6975,2.0,0.0,0.0,3.0,2400,0,1993,0,570000.0,Newcastle,98056,2400
2.0,1.0,780,5000,1.0,0.0,0.0,4.0,780,0,1943,0,285000.0,Seattle,98146,780
3.0,2.0,980,5000,1.0,0.0,0.0,3.0,980,0,1940,1996,435000.0,Seattle,98144,980
3.0,2.0,1480,1961,2.0,0.0,0.0,3.0,1480,0,2005,0,450000.0,Issaquah,98029,1480
4.0,2.0,1320,14250,1.0,0.0,0.0,4.0,1320,0,1954,1979,510000.0,Kirkland,98033,1320
5.0,3.0,4400,18500,1.0,0.0,3.0,5.0,2250,2150,1963,0,1120000.0,Kenmore,98028,4400
3.0,2.0,2260,9568,1.0,0.0,0.0,3.0,1780,480,1985,0,539000.0,Sammamish,98074,2260
4.0,2.0,1880,14653,2.0,0.0,0.0,3.0,1880,0,1978,0,407193.0,Carnation,98014,1880
3.0,2.0,1370,9900,1.0,0.0,0.0,4.0,1370,0,1983,0,320000.0,Milton,98354,1370
4.0,3.0,2720,3800,2.0,0.0,0.0,5.0,1800,920,1919,1934,739000.0,Seattle,98115,2720
2.0,2.0,1740,5400,1.0,0.0,0.0,4.0,990,750,1946,1989,452000.0,Seattle,98115,1740
4.0,2.0,2560,5593,2.0,0.0,0.0,3.0,2560,0,2001,0,600000.0,Redmond,98053,2560
4.0,2.0,2430,4747,2.0,0.0,0.0,3.0,2430,0,2008,0,585000.0,Issaquah,98027,2430
2.0,2.0,1405,1073,2.0,0.0,0.0,3.0,1140,265,2007,0,405000.0,Seattle,98122,1405
5.0,3.0,3030,7679,2.0,0.0,0.0,3.0,3030,0,2014,0,837219.0,Sammamish,98075,3030
4.0,2.0,4150,8436,2.0,0.0,0.0,3.0,4150,0,2014,0,969990.0,Sammamish,98075,4150
3.0,3.0,1730,2940,3.0,0.0,0.0,3.0,1730,0,1985,0,490000.0,Seattle,98117,1730
4.0,2.0,3070,6432,2.0,0.0,0.0,3.0,3070,0,2006,0,462000.0,Renton,98055,3070
4.0,2.0,1780,4169,2.0,0.0,0.0,3.0,1780,0,1994,0,540000.0,Issaquah,98029,1780
4.0,2.0,1811,4381,2.0,0.0,0.0,3.0,1811,0,2007,0,260000.0,Renton,98055,1811
3.0,2.0,2300,7398,2.0,0.0,0.0,3.0,2300,0,2001,0,567500.0,Snoqualmie,98065,2300
2.0,1.0,1440,3225,1.0,0.0,0.0,3.0,960,480,1915,0,445000.0,Seattle,98103,1440
4.0,2.0,2370,9360,2.0,0.0,0.0,4.0,2370,0,1979,0,684680.0,Redmond,98052,2370
3.0,1.0,1300,3550,1.5,0.0,0.0,3.0,1300,0,1927,2011,455000.0,Seattle,98105,1300
5.0,3.0,2870,4369,2.0,0.0,0.0,3.0,2090,780,2007,0,540000.0,Bothell,98011,2870
3.0,3.0,3400,7200,2.0,0.0,2.0,3.0,2470,930,2009,0,530000.0,Renton,98056,3400
3.0,1.0,1410,5060,1.0,0.0,0.0,4.0,910,500,1956,0,410000.0,Seattle,98133,1410
3.0,2.0,1640,13500,1.0,0.0,0.0,3.0,1110,530,1940,1996,450000.0,Seattle,98125,1640
4.0,2.0,3190,7399,2.0,0.0,0.0,3.0,3190,0,2006,0,609900.0,MapleValley,98038,3190
4.0,2.0,2380,13435,2.0,0.0,0.0,3.0,2380,0,1992,0,648000.0,Issaquah,98075,2380
3.0,2.0,2260,4165,2.0,0.0,0.0,3.0,2260,0,2005,0,550000.0,Sammamish,98075,2260
3.0,2.0,1240,8050,1.0,0.0,0.0,4.0,1240,0,1978,2000,347000.0,Sammamish,98074,1240
3.0,2.0,1860,7963,1.0,0.0,0.0,3.0,1200,660,1963,2008,288350.0,Tukwila,98188,1860
3.0,2.0,2210,8000,2.0,0.0,0.0,4.0,2210,0,1969,0,250250.0,FederalWay,98023,2210
4.0,2.0,1920,7665,1.0,0.0,0.0,4.0,1500,420,1975,0,341000.0,Renton,98058,1920
4.0,3.0,3150,7778,2.0,0.0,0.0,3.0,3150,0,2000,0,700000.0,Sammamish,98075,3150
4.0,2.0,2700,7875,1.5,0.0,0.0,4.0,2700,0,1968,0,390000.0,Renton,98058,2700
3.0,2.0,2190,7149,1.0,0.0,1.0,4.0,1240,950,1963,0,539950.0,Renton,98056,2190
2.0,2.0,1380,951,3.0,0.0,0.0,3.0,1380,0,2006,0,552000.0,Seattle,98103,1380
5.0,2.0,2520,5753,1.5,0.0,0.0,4.0,1510,1010,1928,0,250000.0,Enumclaw,98022,2520
3.0,2.0,1300,8800,1.0,0.0,0.0,4.0,1300,0,1963,0,502000.0,Bellevue,98008,1300
4.0,2.0,2220,6500,2.0,0.0,3.0,4.0,2220,0,1964,0,480000.0,Burien,98166,2220
2.0,1.0,730,7528,1.0,0.0,0.0,3.0,730,0,1946,0,378500.0,Seattle,98115,730
4.0,2.0,1980,5909,2.0,0.0,0.0,3.0,1980,0,2003,0,307550.0,Kent,98031,1980
2.0,1.0,740,5995,1.0,0.0,0.0,4.0,740,0,1949,1985,304700.0,Seattle,98133,740
3.0,2.0,2050,3520,1.0,0.0,0.0,4.0,1070,980,1977,0,568000.0,Seattle,98136,2050
3.0,2.0,1230,7500,1.0,0.0,0.0,3.0,1230,0,1987,2000,385000.0,Kirkland,98034,1230
3.0,2.0,1210,1420,3.0,0.0,0.0,3.0,1210,0,2008,0,345000.0,Seattle,98103,1210
3.0,2.0,1890,7200,1.0,0.0,0.0,4.0,1230,660,1973,0,435000.0,Seattle,98125,1890
2.0,2.0,1870,6275,1.0,0.0,0.0,3.0,1870,0,2003,0,579000.0,Redmond,98053,1870
3.0,2.0,1330,6301,1.0,0.0,0.0,3.0,1330,0,1998,2006,236000.0,Auburn,98002,1330
3.0,2.0,1710,10800,1.0,0.0,0.0,4.0,1710,0,1958,1972,368000.0,Kenmore,98028,1710
2.0,1.0,1200,9000,1.0,0.0,2.0,5.0,1200,0,1917,0,255000.0,DesMoines,98198,1200
2.0,1.0,1140,5100,1.0,0.0,0.0,3.0,1140,0,1942,1999,400000.0,Seattle,98136,1140
3.0,2.0,2240,8153,1.0,0.0,0.0,3.0,1120,1120,1948,1994,440000.0,Seattle,98125,2240
2.0,1.0,920,6600,1.0,0.0,0.0,3.0,920,0,1919,2003,417000.0,Seattle,98118,920
2.0,1.0,800,5000,1.0,0.0,0.0,3.0,800,0,1906,2014,435000.0,Seattle,98107,800
4.0,3.0,1980,11443,1.0,0.0,0.0,5.0,1980,0,1952,1998,475000.0,LakeForestPark,98155,1980
4.0,2.0,2800,12831,2.0,0.0,0.0,3.0,2800,0,2001,0,563500.0,Duvall,98019,2800
4.0,2.0,2330,9928,2.0,0.0,0.0,3.0,2330,0,1998,2006,471000.0,NorthBend,98045,2330
4.0,2.0,2240,9886,1.5,0.0,0.0,4.0,2240,0,1965,0,500000.0,Bellevue,98008,2240
3.0,2.0,2140,8925,2.0,0.0,0.0,3.0,2140,0,1991,0,640000.0,Sammamish,98074,2140
4.0,2.0,2170,14024,2.0,0.0,0.0,3.0,2170,0,1992,0,442500.0,Duvall,98019,2170
3.0,2.0,1150,8686,1.0,0.0,0.0,4.0,1150,0,1963,0,213400.0,Renton,98055,1150
4.0,2.0,2030,3905,1.5,0.0,0.0,4.0,1630,400,1926,1993,831000.0,Seattle,98103,2030
3.0,2.0,1350,11805,1.0,0.0,0.0,3.0,1350,0,1986,0,325000.0,Duvall,98019,1350
2.0,1.0,910,4635,1.0,0.0,0.0,4.0,910,0,1905,0,425000.0,Seattle,98107,910
4.0,2.0,2700,5100,1.0,0.0,0.0,4.0,1440,1260,1968,0,550000.0,Seattle,98136,2700
4.0,4.0,3730,15029,2.0,0.0,2.0,3.0,2440,1290,1991,0,599950.0,Kent,98042,3730
4.0,3.0,2050,5000,2.0,0.0,0.0,4.0,1370,680,1987,0,750000.0,Seattle,98112,2050
4.0,3.0,2390,4500,2.0,0.0,0.0,3.0,2390,0,1974,0,290000.0,Renton,98057,2390
4.0,3.0,1990,7252,1.0,0.0,0.0,3.0,1270,720,1999,0,270000.0,Auburn,98002,1990
3.0,1.0,1330,8912,1.0,0.0,0.0,3.0,1330,0,1948,1994,234999.0,SeaTac,98188,1330
4.0,3.0,2190,14937,2.0,0.0,0.0,3.0,2190,0,1993,0,367300.0,Auburn,98001,2190
2.0,2.0,1060,1241,2.0,0.0,0.0,3.0,960,100,2008,0,352750.0,Seattle,98144,1060
2.0,1.0,710,1136,2.0,0.0,0.0,4.0,710,0,1943,0,403950.0,Seattle,98102,710
4.0,2.0,2730,4800,1.5,0.0,0.0,5.0,2230,500,1909,1988,980000.0,Seattle,98119,2730
3.0,2.0,1760,10780,1.0,0.0,0.0,3.0,1760,0,1977,2004,554000.0,Bellevue,98005,1760
3.0,2.0,1530,3464,2.0,0.0,0.0,3.0,1530,0,1998,2006,546000.0,Bellevue,98007,1530
3.0,2.0,1310,2550,1.0,0.0,0.0,3.0,780,530,1986,0,428000.0,Seattle,98103,1310
3.0,3.0,2500,8304,2.0,0.0,0.0,3.0,2500,0,1997,0,364900.0,Kent,98031,2500
3.0,2.0,2070,5386,1.0,0.0,0.0,4.0,1140,930,1948,0,559000.0,Seattle,98117,2070
4.0,2.0,1980,9000,1.0,0.0,0.0,2.0,1480,500,1978,0,213000.0,FederalWay,98023,1980
4.0,1.0,1910,16320,1.5,0.0,0.0,3.0,1910,0,1934,1978,240000.0,Seattle,98106,1910
3.0,2.0,2630,10100,1.0,0.0,0.0,4.0,1580,1050,1967,0,852500.0,Bellevue,98006,2630
3.0,2.0,1960,4400,2.0,0.0,0.0,3.0,1960,0,2006,0,410000.0,Snoqualmie,98065,1960
3.0,2.0,2210,16200,1.0,0.0,0.0,3.0,1390,820,1958,2004,625000.0,Bellevue,98005,2210
3.0,1.0,1590,13000,1.5,0.0,0.0,3.0,1590,0,1944,0,235000.0,Burien,98166,1590
3.0,2.0,1900,6224,2.0,0.0,0.0,3.0,1900,0,2005,0,536000.0,Sammamish,98075,1900
4.0,2.0,2020,7560,1.0,0.0,0.0,4.0,2020,0,1960,2001,379000.0,Renton,98059,2020
2.0,2.0,1340,1210,2.0,0.0,0.0,3.0,1120,220,2008,0,345000.0,Seattle,98144,1340
3.0,2.0,1800,2700,2.0,0.0,0.0,3.0,1800,0,2011,0,365000.0,Seattle,98126,1800
3.0,2.0,1480,1590,2.0,0.0,0.0,3.0,1150,330,2010,0,315000.0,Seattle,98106,1480
4.0,2.0,2750,7807,1.5,0.0,0.0,5.0,2250,500,1916,0,571000.0,Seattle,98125,2750
3.0,3.0,2540,4694,2.0,0.0,0.0,3.0,2540,0,2005,0,695000.0,Sammamish,98074,2540
4.0,2.0,1930,9643,2.0,0.0,0.0,4.0,1930,0,1992,0,315000.0,Kent,98031,1930
2.0,1.0,860,3880,1.0,0.0,0.0,4.0,860,0,1916,0,420000.0,Seattle,98117,860
3.0,2.0,1420,7650,1.0,0.0,0.0,4.0,1100,320,1984,0,310000.0,Renton,98056,1420
3.0,2.0,2080,3880,1.0,0.0,0.0,5.0,1160,920,1954,0,700000.0,Seattle,98117,2080
3.0,2.0,1560,4200,2.0,0.0,0.0,3.0,1560,0,2003,0,269000.0,MapleValley,98038,1560
4.0,2.0,1960,7133,2.0,0.0,0.0,3.0,1960,0,2002,0,369990.0,Renton,98056,1960
3.0,2.0,1620,4500,2.0,0.0,0.0,4.0,1620,0,1926,1993,800000.0,Seattle,98119,1620
5.0,3.0,3670,10583,1.0,0.0,0.0,5.0,2060,1610,1952,1998,569000.0,LakeForestPark,98155,3670
6.0,2.0,1930,8400,1.0,0.0,0.0,3.0,1030,900,1971,0,175000.0,Burien,98146,1930
3.0,2.0,1290,1286,3.0,0.0,0.0,3.0,1290,0,2000,0,440000.0,Seattle,98103,1290
5.0,2.0,1970,15247,1.0,0.0,0.0,3.0,1450,520,1986,0,435000.0,FallCity,98024,1970
3.0,2.0,1540,6909,1.0,0.0,0.0,4.0,920,620,1955,2009,345000.0,Shoreline,98155,1540
3.0,2.0,2220,10275,2.0,0.0,0.0,3.0,1640,580,1980,0,490000.0,Issaquah,98027,2220
3.0,2.0,2430,9133,1.0,0.0,0.0,4.0,1410,1020,1978,2000,335000.0,Renton,98059,2430
4.0,1.0,1120,2685,1.0,0.0,0.0,3.0,860,260,1939,1969,100000.0,Renton,98057,1120
4.0,1.0,1390,10800,1.5,0.0,0.0,4.0,1390,0,1941,1998,417500.0,Seattle,98177,1390
3.0,2.0,2040,7281,1.0,0.0,0.0,3.0,1020,1020,1962,2003,253000.0,Tukwila,98188,2040
4.0,2.0,3020,8302,2.0,0.0,0.0,4.0,3020,0,1994,0,490000.0,Covington,98042,3020
3.0,2.0,2290,14800,1.0,0.0,0.0,3.0,1620,670,1965,1993,470000.0,LakeForestPark,98155,2290
4.0,2.0,1210,11100,1.0,0.0,0.0,4.0,1210,0,1955,2009,483300.0,Bellevue,98006,1210
3.0,2.0,2510,6320,2.0,0.0,0.0,3.0,2510,0,1996,0,659000.0,Sammamish,98075,2510
4.0,2.0,2320,4322,1.0,0.0,0.0,3.0,1140,1180,1910,2006,480000.0,Seattle,98144,2320
3.0,1.0,970,6600,1.0,0.0,0.0,3.0,970,0,1965,1993,165000.0,Burien,98168,970
3.0,2.0,1820,5500,1.0,0.0,0.0,4.0,1620,200,1957,2001,659500.0,Seattle,98115,1820
3.0,1.0,970,7742,1.0,0.0,0.0,4.0,970,0,1967,0,219900.0,FederalWay,98003,970
2.0,1.0,1740,3622,1.0,0.0,0.0,4.0,950,790,1924,0,315000.0,Seattle,98118,1740
3.0,2.0,1590,7560,1.0,0.0,0.0,3.0,1130,460,1984,0,250000.0,Kent,98031,1590
2.0,1.0,1380,5000,1.0,0.0,0.0,3.0,870,510,1943,2002,268000.0,Seattle,98108,1380
4.0,2.0,1680,11123,1.0,0.0,0.0,3.0,1130,550,1959,1989,380000.0,Shoreline,98177,1680
2.0,1.0,1220,3000,1.0,0.0,0.0,3.0,920,300,1926,2003,499000.0,Seattle,98117,1220
2.0,2.0,1651,18200,1.0,0.0,0.0,3.0,1651,0,1946,0,285000.0,Vashon,98070,1651
3.0,2.0,1330,9200,1.0,0.0,0.0,4.0,1330,0,1973,0,183000.0,Auburn,98092,1330
3.0,3.0,2940,4622,2.0,0.0,0.0,4.0,2230,710,1988,0,1070000.0,Seattle,98105,2940
3.0,3.0,1410,1246,3.0,0.0,0.0,3.0,1410,0,2005,0,429000.0,Seattle,98103,1410
2.0,1.0,1100,3598,1.0,0.0,0.0,4.0,1100,0,1926,1993,403000.0,Seattle,98144,1100
3.0,2.0,1530,7200,1.0,0.0,0.0,3.0,1530,0,1975,0,375500.0,LakeForestPark,98155,1530
3.0,2.0,2110,5150,1.0,0.0,0.0,5.0,1080,1030,1919,1934,516200.0,Seattle,98118,2110
4.0,2.0,1720,8750,1.0,0.0,0.0,3.0,860,860,1971,0,385000.0,Kirkland,98034,1720
3.0,2.0,1800,5001,2.0,0.0,0.0,3.0,1800,0,1996,0,515000.0,Kirkland,98034,1800
4.0,2.0,2210,9427,2.0,0.0,0.0,3.0,2210,0,1999,0,375000.0,Burien,98148,2210
4.0,2.0,2560,9731,2.0,0.0,0.0,4.0,2560,0,1973,0,650000.0,Kirkland,98034,2560
2.0,2.0,1010,7719,2.0,0.0,0.0,3.0,1010,0,1981,2013,306888.0,Renton,98056,1010
4.0,2.0,3340,12248,2.0,0.0,1.0,3.0,2470,870,1998,2006,870000.0,Seattle,98126,3340
4.0,1.0,1740,11075,1.5,0.0,0.0,3.0,1740,0,1965,1993,310000.0,Shoreline,98133,1740
3.0,2.0,1320,7200,1.0,0.0,0.0,5.0,1320,0,1975,0,251750.0,Kent,98031,1320
3.0,2.0,1520,8625,1.0,0.0,0.0,3.0,1520,0,1976,0,366000.0,Bothell,98011,1520
3.0,2.0,2010,9480,1.0,0.0,0.0,3.0,1570,440,1951,1994,429950.0,Seattle,98125,2010
3.0,4.0,2440,3427,2.0,0.0,0.0,3.0,1990,450,2000,0,710000.0,Bellevue,98005,2440
3.0,1.0,1010,9450,1.0,0.0,0.0,4.0,1010,0,1959,0,149500.0,DesMoines,98198,1010
3.0,2.0,1780,6771,1.0,0.0,0.0,3.0,1230,550,1990,2009,310000.0,Seattle,98106,1780
3.0,2.0,2180,4976,1.5,0.0,2.0,4.0,1680,500,1930,0,555000.0,Seattle,98126,2180
5.0,3.0,2750,7500,2.0,0.0,1.0,3.0,2150,600,1937,1997,750000.0,Kirkland,98033,2750
4.0,3.0,3490,7024,2.0,0.0,0.0,3.0,3490,0,2006,0,745000.0,Sammamish,98075,3490
3.0,2.0,1870,7189,1.0,0.0,0.0,3.0,1270,600,1959,1989,433000.0,Seattle,98118,1870
4.0,1.0,1150,8184,1.5,0.0,0.0,3.0,1150,0,1947,2012,307000.0,Shoreline,98155,1150
3.0,2.0,2050,11856,1.0,0.0,0.0,3.0,1460,590,1962,2003,655275.0,Bellevue,98006,2050
4.0,3.0,1940,6555,2.0,0.0,0.0,3.0,1940,0,1990,2009,392000.0,MapleValley,98038,1940
3.0,2.0,1890,9100,2.0,0.0,0.0,4.0,1890,0,1952,0,359950.0,Shoreline,98133,1890
4.0,2.0,1630,10375,1.0,0.0,0.0,5.0,1630,0,1968,0,360000.0,Woodinville,98077,1630
4.0,2.0,2440,5000,1.0,0.0,0.0,3.0,1340,1100,1954,2005,566000.0,Seattle,98117,2440
5.0,3.0,3100,9825,2.0,0.0,2.0,4.0,3100,0,1950,1982,700000.0,Seattle,98125,3100
3.0,2.0,2090,6045,2.0,0.0,0.0,3.0,2090,0,2000,0,415000.0,Renton,98056,2090
3.0,1.0,920,9812,1.0,0.0,0.0,4.0,920,0,1962,0,199500.0,Auburn,98001,920
3.0,1.0,1580,5000,1.5,0.0,0.0,3.0,1580,0,1926,2003,749000.0,Seattle,98117,1580
3.0,2.0,1760,8400,1.0,0.0,0.0,4.0,1460,300,1960,2001,680000.0,Seattle,98136,1760
4.0,2.0,2530,7563,1.0,0.0,0.0,3.0,1440,1090,1978,0,400000.0,Bothell,98011,2530
4.0,3.0,2490,9714,1.0,0.0,0.0,4.0,1400,1090,1983,0,608000.0,Bothell,98011,2490
5.0,2.0,2732,9500,1.0,0.0,2.0,4.0,1870,862,1975,0,480000.0,FederalWay,98003,2732
5.0,3.0,3230,3825,2.0,0.0,0.0,3.0,2480,750,2014,0,1059500.0,Seattle,98117,3230
4.0,4.0,3510,9364,2.0,0.0,0.0,3.0,3510,0,2001,0,695000.0,Snoqualmie,98065,3510
2.0,2.0,1060,1208,2.0,0.0,0.0,3.0,940,120,2005,0,499950.0,Seattle,98102,1060
4.0,2.0,2009,5000,2.0,0.0,0.0,3.0,2009,0,2014,0,303210.0,Auburn,98092,2009
5.0,3.0,2880,8364,2.0,0.0,0.0,3.0,2880,0,2006,0,525000.0,Renton,98059,2880
2.0,1.0,710,1157,2.0,0.0,0.0,4.0,710,0,1943,0,399950.0,Seattle,98102,710
3.0,2.0,2070,13241,1.5,0.0,0.0,5.0,1270,800,1910,0,850830.0,Seattle,98102,2070
3.0,2.0,1370,8336,1.0,0.0,0.0,5.0,1370,0,1964,0,371500.0,Shoreline,98133,1370
3.0,2.0,1730,8400,1.0,0.0,0.0,4.0,1400,330,1980,0,522000.0,Redmond,98052,1730
4.0,2.0,1680,5000,1.0,0.0,0.0,3.0,980,700,1950,2005,588000.0,Seattle,98115,1680
2.0,1.0,1350,10096,1.0,0.0,2.0,4.0,1350,0,1952,0,276900.0,NorthBend,98045,1350
5.0,2.0,1510,9078,1.0,0.0,0.0,4.0,1510,0,1959,0,248000.0,SeaTac,98168,1510
3.0,2.0,1860,6607,2.0,0.0,0.0,3.0,1860,0,1989,0,280000.0,FederalWay,98023,1860
6.0,5.0,3440,4500,2.0,0.0,0.0,3.0,3280,160,2007,0,495000.0,Renton,98057,3440
6.0,3.0,4250,4400,2.5,0.0,0.0,4.0,3020,1230,1902,0,665000.0,Seattle,98118,4250
2.0,1.0,860,3874,1.0,0.0,0.0,4.0,860,0,1931,0,290300.0,Renton,98057,860
2.0,2.0,1640,4080,1.0,0.0,0.0,3.0,840,800,1921,2000,527000.0,Seattle,98105,1640
2.0,2.0,1295,1093,2.0,0.0,0.0,3.0,1105,190,2007,0,487028.0,Seattle,98122,1295
3.0,2.0,2210,6300,1.5,0.0,0.0,5.0,2210,0,1916,0,799000.0,Seattle,98144,2210
3.0,1.0,940,10368,1.0,0.0,0.0,3.0,940,0,1965,1993,354000.0,Redmond,98052,940
3.0,2.0,1160,8906,1.0,0.0,0.0,3.0,1160,0,1962,2003,262500.0,Seattle,98118,1160
3.0,1.0,1050,6300,1.0,0.0,0.0,3.0,1050,0,1942,1999,220000.0,Seattle,98146,1050
2.0,1.0,1030,5750,1.0,0.0,0.0,5.0,1030,0,1928,1970,650000.0,Seattle,98116,1030
4.0,4.0,2690,4000,2.0,0.0,3.0,4.0,2120,570,1909,1989,800000.0,Seattle,98119,2690
2.0,1.0,700,4700,1.0,0.0,0.0,5.0,700,0,1953,0,200000.0,Renton,98056,700
5.0,4.0,2100,5107,2.0,0.0,0.0,3.0,1410,690,1999,0,295000.0,Seattle,98178,2100
3.0,2.0,1870,4060,2.0,0.0,0.0,3.0,1870,0,2005,0,285000.0,Kent,98042,1870
3.0,2.0,1520,15090,1.0,0.0,0.0,4.0,1520,0,1968,0,290000.0,MapleValley,98038,1520
3.0,2.0,1460,11407,1.0,0.0,0.0,3.0,1460,0,1954,2005,381000.0,LakeForestPark,98155,1460
3.0,2.0,2600,7465,2.0,0.0,0.0,3.0,2600,0,1988,2000,571000.0,Bothell,98011,2600
4.0,2.0,3320,11901,2.0,0.0,0.0,5.0,2650,670,1977,0,852600.0,Bellevue,98006,3320
5.0,2.0,2340,6000,2.0,0.0,0.0,4.0,2340,0,1922,0,1085000.0,Seattle,98144,2340
3.0,1.0,890,7200,1.0,0.0,0.0,3.0,890,0,1951,1994,371000.0,Seattle,98125,890
3.0,2.0,1720,5899,1.0,0.0,1.0,3.0,1220,500,1986,0,514000.0,Seattle,98136,1720
4.0,2.0,2180,7203,2.0,0.0,0.0,4.0,2180,0,1989,0,464000.0,Renton,98059,2180
4.0,2.0,2030,13500,1.0,0.0,0.0,3.0,1230,800,1963,2008,335000.0,Renton,98059,2030
4.0,3.0,2490,17833,2.0,0.0,2.0,3.0,1490,1000,1979,2014,740000.0,Seattle,98125,2490
4.0,2.0,1470,5350,1.0,0.0,0.0,3.0,980,490,1955,2005,465000.0,Seattle,98125,1470
3.0,3.0,2500,7378,1.0,0.0,0.0,5.0,1390,1110,1948,1985,700000.0,Seattle,98177,2500
3.0,3.0,1460,1592,2.0,0.0,0.0,3.0,1130,330,2006,0,350000.0,Seattle,98126,1460
1.0,1.0,620,8261,1.0,0.0,0.0,3.0,620,0,1939,1969,148000.0,Seattle,98106,620
3.0,2.0,1550,3680,1.0,0.0,0.0,3.0,1050,500,1927,2011,530000.0,Seattle,98117,1550
3.0,2.0,1430,1002,3.0,0.0,0.0,3.0,1430,0,2002,0,349000.0,Seattle,98103,1430
3.0,2.0,1360,9760,1.5,0.0,0.0,5.0,1360,0,1984,0,240000.0,NorthBend,98045,1360
3.0,2.0,2210,7557,2.0,0.0,0.0,3.0,2210,0,1989,0,330000.0,FederalWay,98023,2210
4.0,2.0,2460,5100,1.5,0.0,0.0,5.0,1450,1010,1909,1988,735000.0,Seattle,98115,2460
3.0,2.0,2180,15693,1.0,0.0,0.0,4.0,1850,330,1979,0,545000.0,Sammamish,98075,2180
3.0,2.0,1570,4875,1.0,0.0,0.0,4.0,1310,260,1977,0,214950.0,Covington,98042,1570
3.0,1.0,1140,5500,1.5,0.0,0.0,4.0,1140,0,1908,0,476000.0,Seattle,98199,1140
2.0,1.0,800,15000,1.0,0.0,0.0,3.0,800,0,1927,2011,110000.0,Seattle,98168,800
4.0,3.0,2414,7693,2.0,0.0,0.0,3.0,2414,0,2006,0,292000.0,Auburn,98002,2414
3.0,1.0,1160,8813,1.0,0.0,0.0,3.0,1160,0,1952,2008,317000.0,Seattle,98125,1160
4.0,2.0,3170,10688,2.0,0.0,2.0,3.0,3170,0,2001,0,455000.0,Auburn,98001,3170
3.0,2.0,2060,4437,1.0,0.0,0.0,3.0,1030,1030,1929,0,460000.0,Seattle,98126,2060
3.0,2.0,1640,7201,1.0,0.0,0.0,3.0,1640,0,1948,1994,405000.0,Seattle,98125,1640
2.0,1.0,720,6686,1.0,0.0,0.0,3.0,720,0,1942,1999,333000.0,Seattle,98117,720
4.0,1.0,1860,4736,1.5,0.0,0.0,1.0,1860,0,1901,0,427000.0,Seattle,98112,1860
4.0,2.0,2810,10986,2.0,0.0,0.0,3.0,2810,0,1997,0,742000.0,Sammamish,98075,2810
4.0,2.0,2090,9702,1.0,0.0,0.0,5.0,1320,770,1965,0,465000.0,Shoreline,98133,2090
4.0,2.0,3280,6181,2.0,0.0,0.0,3.0,3280,0,2001,0,809950.0,Sammamish,98074,3280
4.0,2.0,2090,3610,1.5,0.0,0.0,5.0,1790,300,1927,0,619400.0,Seattle,98115,2090
3.0,2.0,2430,14607,1.0,0.0,1.0,3.0,1230,1200,1949,1970,762400.0,MercerIsland,98040,2430
5.0,3.0,2510,4125,1.5,0.0,3.0,5.0,1590,920,1925,0,881000.0,Seattle,98144,2510
4.0,3.0,3370,6675,1.0,0.0,3.0,4.0,1920,1450,1948,0,813000.0,Seattle,98144,3370
3.0,2.0,1640,5280,1.5,0.0,0.0,5.0,1640,0,1910,0,234000.0,Auburn,98002,1640
3.0,2.0,2250,7294,2.0,0.0,0.0,3.0,2250,0,1994,0,308900.0,Auburn,98092,2250
4.0,2.0,2300,19250,1.0,0.0,0.0,4.0,2300,0,1955,2009,450000.0,NorthBend,98045,2300
3.0,4.0,1650,2262,3.0,0.0,0.0,3.0,1650,0,2010,0,547500.0,Seattle,98103,1650
2.0,1.0,710,1131,2.0,0.0,0.0,4.0,710,0,1943,0,399950.0,Seattle,98102,710
4.0,4.0,2550,8698,2.0,0.0,0.0,3.0,2550,0,2007,0,516000.0,Snoqualmie,98065,2550
2.0,2.0,982,846,2.0,0.0,0.0,3.0,806,176,2006,0,250000.0,Seattle,98133,982
3.0,2.0,1630,2520,2.0,0.0,0.0,3.0,1630,0,2005,0,475000.0,Issaquah,98029,1630
4.0,2.0,2550,4500,2.0,0.0,0.0,3.0,2550,0,2009,0,415000.0,Renton,98059,2550
2.0,1.0,1240,2150,2.0,0.0,0.0,3.0,1240,0,2014,0,545000.0,Seattle,98117,1240
4.0,2.0,2180,7297,2.0,0.0,0.0,3.0,2180,0,1984,0,610750.0,Sammamish,98074,2180
4.0,2.0,3140,9225,1.0,0.0,2.0,5.0,1770,1370,1966,0,578000.0,Renton,98057,3140
3.0,2.0,1970,7972,1.0,0.0,3.0,5.0,1370,600,1976,0,501000.0,Renton,98057,1970
5.0,2.0,1940,7642,1.5,0.0,0.0,3.0,1940,0,1957,2000,465250.0,Shoreline,98177,1940
0.0,0.0,3064,4764,3.5,0.0,2.0,3.0,3064,0,1990,2009,1095000.0,Seattle,98102,3064
2.0,1.0,970,5665,1.0,0.0,0.0,4.0,970,0,1908,0,315000.0,Seattle,98118,970
4.0,2.0,3010,6100,2.0,0.0,0.0,3.0,3010,0,2005,0,789500.0,Redmond,98052,3010
3.0,2.0,2460,6600,1.0,0.0,2.0,4.0,1370,1090,1952,0,678500.0,Seattle,98136,2460
3.0,2.0,2080,11375,1.0,0.0,0.0,3.0,2080,0,2002,0,342500.0,Enumclaw,98022,2080
4.0,3.0,3960,7012,2.0,0.0,0.0,3.0,3960,0,2005,0,860000.0,Sammamish,98075,3960
4.0,2.0,2490,8124,2.0,0.0,0.0,3.0,2490,0,2001,0,306000.0,Auburn,98092,2490
5.0,2.0,2060,6000,2.0,0.0,0.0,3.0,2060,0,1903,2005,580000.0,Seattle,98105,2060
3.0,1.0,1330,15678,1.0,0.0,0.0,3.0,900,430,1984,0,405000.0,Sammamish,98074,1330
3.0,2.0,1600,19200,1.0,0.0,0.0,4.0,1600,0,1967,0,510000.0,Kirkland,98034,1600
2.0,1.0,820,10450,1.0,0.0,0.0,4.0,820,0,1965,0,173000.0,Renton,98055,820
4.0,2.0,1200,7680,1.0,0.0,0.0,3.0,1200,0,1968,1997,210000.0,Auburn,98092,1200
3.0,1.0,1050,5664,1.0,0.0,0.0,4.0,910,140,1947,1988,445000.0,Seattle,98115,1050
3.0,2.0,1910,1501,2.5,0.0,0.0,3.0,1530,380,2007,0,585000.0,Seattle,98199,1910
3.0,2.0,1800,6000,1.0,0.0,0.0,5.0,900,900,1950,0,381000.0,Shoreline,98155,1800
3.0,2.0,2060,8640,1.0,0.0,0.0,4.0,2060,0,1966,0,890000.0,Kirkland,98033,2060
3.0,2.0,1840,9697,1.0,0.0,0.0,4.0,1500,340,1985,0,235000.0,Kent,98030,1840
3.0,2.0,1250,1103,3.0,0.0,2.0,3.0,1250,0,2005,0,480000.0,Seattle,98103,1250
2.0,1.0,1510,4032,1.5,0.0,0.0,3.0,1310,200,1935,1974,575000.0,Seattle,98199,1510
4.0,2.0,2300,4600,1.5,0.0,0.0,4.0,1340,960,1904,0,350000.0,Seattle,98144,2300
5.0,3.0,2820,4608,1.0,0.0,0.0,3.0,1450,1370,1967,2011,599000.0,Seattle,98117,2820
4.0,2.0,1130,7840,1.0,0.0,0.0,4.0,1130,0,1970,0,210000.0,FederalWay,98023,1130
3.0,1.0,1510,5000,1.5,0.0,0.0,3.0,1510,0,1909,2004,545000.0,Seattle,98105,1510
3.0,2.0,1970,7500,2.0,0.0,0.0,3.0,1970,0,1988,2000,299995.0,Auburn,98092,1970
3.0,1.0,1210,5750,1.5,0.0,0.0,4.0,1210,0,1910,0,440000.0,Seattle,98136,1210
3.0,2.0,2420,17859,1.0,0.0,1.0,5.0,1500,920,1979,0,795000.0,Kirkland,98034,2420
5.0,2.0,2460,6846,1.5,0.0,0.0,5.0,1340,1120,1911,1984,445000.0,Seattle,98108,2460
3.0,1.0,1180,11862,1.0,0.0,0.0,4.0,1180,0,1948,0,397990.0,Seattle,98177,1180
3.0,3.0,1900,6400,1.0,0.0,0.0,5.0,1410,490,1942,0,706000.0,Seattle,98105,1900
3.0,3.0,1651,1779,2.0,0.0,0.0,3.0,1341,310,2008,0,363000.0,Seattle,98133,1651
4.0,2.0,2130,11843,2.0,0.0,0.0,4.0,2130,0,1972,0,850000.0,MercerIsland,98040,2130
2.0,1.0,1430,3000,1.5,0.0,0.0,3.0,1300,130,1929,0,620000.0,Seattle,98112,1430
4.0,2.0,1910,9244,1.0,0.0,0.0,4.0,1910,0,1963,0,333000.0,Renton,98059,1910
3.0,2.0,2110,11250,1.0,0.0,0.0,4.0,2110,0,1961,2001,743000.0,MercerIsland,98040,2110
2.0,2.0,1630,3780,1.0,0.0,0.0,4.0,890,740,1940,2001,448000.0,Seattle,98107,1630
5.0,3.0,2990,7420,2.0,0.0,0.0,3.0,2990,0,1996,0,498500.0,Renton,98059,2990
3.0,2.0,2120,9736,2.0,0.0,0.0,3.0,2120,0,1988,2000,531000.0,Bothell,98011,2120
3.0,2.0,2050,6420,1.0,0.0,3.0,3.0,1730,320,1956,2001,670000.0,Seattle,98116,2050
5.0,3.0,1880,5000,1.0,0.0,0.0,3.0,1100,780,1997,0,310000.0,Seattle,98106,1880
3.0,3.0,2790,12523,2.0,1.0,4.0,4.0,1600,1190,1977,0,835000.0,DesMoines,98198,2790
4.0,2.0,2140,7245,2.0,0.0,0.0,3.0,2140,0,2003,0,495000.0,Seattle,98133,2140
3.0,2.0,1769,9300,1.0,0.0,0.0,4.0,1769,0,1955,2009,495000.0,NormandyPark,98166,1769
3.0,1.0,1710,6556,1.5,0.0,0.0,4.0,1200,510,1926,1993,440000.0,Seattle,98133,1710
1.0,1.0,420,6720,1.0,0.0,0.0,3.0,420,0,1922,2008,280000.0,Seattle,98108,420
4.0,2.0,2370,10858,2.0,0.0,0.0,3.0,2370,0,2003,0,1034500.0,Bellevue,98004,2370
4.0,2.0,1770,5855,2.0,0.0,0.0,3.0,1770,0,2003,0,248000.0,MapleValley,98038,1770
4.0,2.0,2210,8465,1.0,0.0,0.0,3.0,1490,720,1990,2009,294000.0,Auburn,98092,2210
4.0,2.0,2710,4750,1.0,0.0,0.0,4.0,1460,1250,1919,1985,656500.0,Seattle,98115,2710
3.0,3.0,2340,2970,2.0,0.0,0.0,5.0,2160,180,1925,0,660000.0,Seattle,98103,2340
2.0,1.0,1220,17172,1.0,0.0,0.0,4.0,1220,0,1947,1988,370000.0,Kirkland,98033,1220
2.0,1.0,910,9869,1.0,0.0,0.0,3.0,910,0,1957,2000,223000.0,Renton,98058,910
4.0,2.0,1880,3880,1.5,0.0,0.0,4.0,1090,790,1944,0,560000.0,Seattle,98107,1880
4.0,2.0,1870,5200,2.0,0.0,0.0,4.0,1200,670,1937,0,594000.0,Seattle,98115,1870
3.0,2.0,1480,5400,2.0,0.0,0.0,4.0,1480,0,1914,1945,600000.0,Seattle,98122,1480
3.0,2.0,1880,7000,2.0,0.0,0.0,3.0,1880,0,1993,0,315000.0,Kent,98031,1880
4.0,2.0,1890,6000,1.0,0.0,0.0,4.0,1110,780,1947,1988,430000.0,Seattle,98125,1890
3.0,3.0,1560,7392,1.0,0.0,0.0,5.0,1030,530,1972,0,440000.0,Kirkland,98034,1560
2.0,2.0,1070,1200,2.0,0.0,0.0,3.0,1070,0,1999,0,312500.0,Seattle,98103,1070
3.0,3.0,1470,1235,2.0,0.0,0.0,3.0,1180,290,2008,0,300000.0,Seattle,98108,1470
3.0,2.0,2570,3600,2.5,0.0,0.0,3.0,2570,0,2007,0,680000.0,Issaquah,98029,2570
2.0,2.0,1170,1011,2.0,0.0,0.0,3.0,1170,0,2009,0,336750.0,Issaquah,98027,1170
5.0,4.0,2320,4960,2.0,0.0,0.0,5.0,1720,600,1926,0,822500.0,Seattle,98103,2320
4.0,3.0,2440,9600,2.0,0.0,0.0,5.0,2440,0,1961,0,589000.0,Kirkland,98034,2440
2.0,2.0,1440,5680,1.0,0.0,0.0,4.0,1440,0,1978,2000,210000.0,DesMoines,98198,1440
3.0,1.0,1340,11070,1.0,0.0,0.0,4.0,1340,0,1978,2000,206135.0,Kent,98030,1340
6.0,4.0,3010,4360,2.0,0.0,0.0,3.0,2000,1010,2014,0,1125000.0,Seattle,98103,3010
3.0,2.0,1840,8601,1.0,0.0,0.0,3.0,920,920,1905,2014,285000.0,Seattle,98118,1840
2.0,1.0,930,7550,1.0,0.0,0.0,3.0,930,0,1986,0,230000.0,SeaTac,98168,930
3.0,2.0,1820,9545,1.0,0.0,0.0,3.0,1230,590,1976,0,350000.0,LakeForestPark,98155,1820
3.0,1.0,1280,8184,1.5,0.0,0.0,4.0,1280,0,1947,1988,304000.0,Shoreline,98155,1280
2.0,1.0,900,4600,1.0,0.0,0.0,3.0,900,0,1951,1994,370000.0,Seattle,98117,900
3.0,2.0,1980,13503,1.0,0.0,2.0,4.0,1320,660,1952,0,810000.0,Bellevue,98008,1980
4.0,2.0,2010,7575,1.0,0.0,0.0,3.0,1220,790,1974,0,440000.0,Kirkland,98034,2010
4.0,2.0,2750,4800,2.0,0.0,0.0,3.0,1960,790,1905,2005,1030000.0,Seattle,98103,2750
4.0,2.0,3140,10875,1.0,0.0,1.0,3.0,1940,1200,1939,1969,775000.0,Seattle,98199,3140
3.0,2.0,1900,8540,1.0,0.0,0.0,3.0,950,950,1980,0,235000.0,SeaTac,98168,1900
3.0,1.0,1830,3000,1.5,0.0,0.0,3.0,1430,400,1926,2003,499950.0,Seattle,98103,1830
4.0,2.0,2700,10814,1.0,0.0,0.0,4.0,1560,1140,1966,0,300000.0,Kent,98030,2700
3.0,1.0,1290,6566,1.0,0.0,0.0,5.0,1290,0,1976,0,205000.0,FederalWay,98023,1290
3.0,2.0,1500,8173,1.0,0.0,0.0,3.0,1500,0,1997,0,435000.0,Kirkland,98034,1500
3.0,1.0,1270,6405,1.5,0.0,0.0,3.0,1270,0,1944,0,153000.0,Seattle,98178,1270
3.0,1.0,1870,2807,1.5,0.0,0.0,4.0,1580,290,1927,0,585000.0,Seattle,98107,1870
4.0,2.0,2540,6365,2.0,0.0,0.0,3.0,1870,670,2000,0,380000.0,Renton,98055,2540
4.0,2.0,1930,8660,1.0,0.0,0.0,3.0,1120,810,1981,2013,250600.0,Auburn,98001,1930
4.0,2.0,2770,13500,2.0,0.0,0.0,3.0,2770,0,1974,0,890000.0,MercerIsland,98040,2770
4.0,2.0,2220,5338,2.0,0.0,0.0,3.0,2220,0,2001,0,370000.0,Renton,98059,2220
3.0,2.0,1650,9957,1.0,0.0,0.0,4.0,1100,550,1961,2001,369500.0,Seattle,98125,1650
3.0,2.0,1210,5240,1.0,0.0,0.0,4.0,610,600,1983,0,305000.0,Seattle,98106,1210
4.0,2.0,2010,7972,2.0,0.0,0.0,4.0,2010,0,1989,0,590000.0,Issaquah,98029,2010
3.0,2.0,1580,6065,2.0,0.0,0.0,3.0,1580,0,1985,0,485000.0,Issaquah,98029,1580
2.0,1.0,710,7200,1.0,0.0,0.0,3.0,710,0,1943,2002,215000.0,Seattle,98178,710
3.0,2.0,1910,5040,1.5,0.0,0.0,3.0,1910,0,1971,0,430000.0,Sammamish,98074,1910
4.0,2.0,1880,7965,2.0,0.0,0.0,3.0,1880,0,2000,0,324900.0,MapleValley,98038,1880
5.0,3.0,3100,10014,1.0,0.0,2.0,4.0,1660,1440,1973,0,975000.0,MercerIsland,98040,3100
5.0,2.0,2350,4000,2.0,0.0,0.0,3.0,2350,0,1993,0,910000.0,Seattle,98112,2350
3.0,2.0,1850,6869,1.0,0.0,2.0,5.0,1100,750,1919,1934,459950.0,Burien,98166,1850
3.0,2.0,2070,8337,2.0,0.0,0.0,3.0,2070,0,1997,0,325000.0,Kent,98030,2070
4.0,3.0,2020,7070,1.0,0.0,0.0,5.0,1010,1010,1958,0,513000.0,Seattle,98126,2020
3.0,2.0,1580,12177,1.0,0.0,0.0,3.0,1200,380,1981,2013,475000.0,Sammamish,98074,1580
4.0,2.0,2690,7947,2.0,0.0,0.0,3.0,2690,0,1993,0,419000.0,Renton,98058,2690
4.0,2.0,2420,10285,1.0,0.0,4.0,3.0,1700,720,1958,2004,760000.0,Burien,98146,2420
5.0,2.0,2540,6660,2.0,0.0,3.0,4.0,2340,200,1954,1979,1120000.0,Seattle,98136,2540
5.0,2.0,3210,12000,1.0,0.0,0.0,4.0,1830,1380,1968,0,725000.0,Bellevue,98007,3210
3.0,2.0,2040,4627,2.0,0.0,0.0,3.0,2040,0,1992,0,580000.0,Redmond,98052,2040
3.0,2.0,1920,4833,1.0,0.0,0.0,4.0,1060,860,1921,0,385000.0,Seattle,98133,1920
4.0,2.0,1900,10588,1.0,0.0,0.0,5.0,1900,0,1958,0,265000.0,Auburn,98002,1900
3.0,2.0,1070,1155,2.0,0.0,0.0,3.0,720,350,2005,0,330000.0,Seattle,98116,1070
3.0,2.0,2860,4442,2.0,0.0,0.0,3.0,2860,0,2000,0,799000.0,Seattle,98199,2860
3.0,2.0,2250,8800,1.0,0.0,0.0,4.0,1250,1000,1925,1968,589000.0,Seattle,98116,2250
4.0,2.0,2400,7351,2.0,0.0,0.0,3.0,2400,0,1990,2009,650000.0,Kirkland,98033,2400
3.0,2.0,1530,8000,2.0,0.0,0.0,3.0,1530,0,1978,0,474000.0,Woodinville,98077,1530
4.0,2.0,2090,6630,1.0,0.0,0.0,3.0,1070,1020,1974,0,203400.0,Renton,98055,2090
3.0,2.0,2570,4600,2.0,0.0,0.0,3.0,2570,0,2014,0,339990.0,MercerIsland,98040,2570
4.0,2.0,1450,8891,1.5,0.0,0.0,3.0,1180,270,1962,2003,235000.0,Seattle,98177,1450
4.0,3.0,2310,5650,1.0,0.0,2.0,3.0,1330,980,1952,2012,450000.0,LakeForestPark,98155,2310
3.0,2.0,1400,11400,2.0,0.0,0.0,3.0,1400,0,1984,0,374500.0,Seattle,98126,1400
2.0,3.0,1430,1425,2.0,0.0,0.0,3.0,995,435,2006,0,465000.0,Kirkland,98033,1430
2.0,1.0,820,4320,1.0,0.0,0.0,3.0,820,0,1937,1999,102500.0,Seattle,98117,820
3.0,2.0,1570,7200,1.0,0.0,0.0,4.0,1570,0,1952,0,176225.0,Seattle,98122,1570
3.0,1.0,1060,7920,1.0,0.0,0.0,4.0,1060,0,1968,0,326500.0,MapleValley,98038,1060
1.0,1.0,1100,638,3.0,0.0,0.0,3.0,1100,0,2014,0,516500.0,Sammamish,98074,1100
3.0,2.0,1530,9406,1.0,0.0,0.0,3.0,1270,260,1993,0,332000.0,Woodinville,98077,1530
3.0,1.0,1430,10005,1.5,0.0,0.0,4.0,1430,0,1950,1983,400000.0,Covington,98042,1430
2.0,1.0,1100,8281,1.0,0.0,0.0,4.0,1100,0,1947,1988,229629.5,Renton,98056,1100
4.0,2.0,2360,10000,1.0,0.0,3.0,3.0,1980,380,1977,2004,633000.0,Enumclaw,98022,2360
4.0,2.0,2100,13468,1.0,0.0,0.0,5.0,1050,1050,1962,0,475000.0,Woodinville,98072,2100
3.0,3.0,2470,10125,2.0,0.0,0.0,3.0,2470,0,1960,2012,970500.0,Auburn,98092,2470
4.0,2.0,2040,8265,2.0,0.0,0.0,3.0,2040,0,1996,0,355000.0,Auburn,98002,2040
5.0,3.0,3160,5000,2.0,0.0,2.0,3.0,2180,980,2005,0,957000.0,Bellevue,98006,3160
4.0,2.0,2290,5350,2.0,0.0,0.0,4.0,2120,170,1958,1972,535000.0,Seattle,98178,2290
5.0,3.0,2740,9629,1.0,0.0,0.0,5.0,1390,1350,1977,0,515000.0,Seattle,98177,2740
5.0,2.0,1260,4500,1.5,0.0,0.0,3.0,1260,0,1926,2003,650000.0,Seattle,98112,1260
5.0,4.0,5960,13703,2.0,0.0,2.0,3.0,4770,1190,1984,0,452500.0,Woodinville,98072,5960
2.0,2.0,1090,2686,2.0,0.0,0.0,3.0,1090,0,1982,0,249000.0,Redmond,98052,1090
3.0,2.0,2270,11472,1.0,0.0,0.0,4.0,1370,900,1956,0,645000.0,Redmond,98052,2270
3.0,2.0,2410,8944,1.0,0.0,0.0,4.0,1860,550,1967,0,415000.0,Seattle,98168,2410
3.0,2.0,1470,4322,2.0,0.0,0.0,3.0,1470,0,1985,0,491500.0,Renton,98059,1470
5.0,1.0,1170,6757,1.0,0.0,0.0,4.0,800,370,1944,0,397000.0,Kirkland,98034,1170
2.0,2.0,880,1805,2.0,0.0,0.0,3.0,880,0,1999,0,235000.0,Bellevue,98006,880
3.0,2.0,1950,6871,2.0,0.0,0.0,3.0,1950,0,1997,0,375000.0,Seattle,98119,1950
3.0,2.0,1620,6630,1.0,0.0,0.0,3.0,1280,340,1954,2005,620000.0,Seattle,98107,1620
2.0,2.0,1190,3400,1.0,0.0,0.0,3.0,990,200,1919,2001,441000.0,LakeForestPark,98155,1190
3.0,2.0,1600,10240,1.0,0.0,0.0,3.0,1090,510,1979,2014,390000.0,Seattle,98133,1600
3.0,2.0,1870,5909,1.0,0.0,0.0,3.0,1270,600,1986,0,259000.0,MercerIsland,98040,1870
4.0,2.0,3670,9958,2.0,0.0,0.0,3.0,3670,0,2005,0,525000.0,Sammamish,98074,3670
3.0,2.0,1330,7600,1.0,0.0,0.0,4.0,1330,0,1968,0,218000.0,Seattle,98102,1330
4.0,4.0,4140,7089,2.0,0.0,0.0,3.0,3160,980,2003,0,850000.0,Newcastle,98056,4140
4.0,2.0,2130,5080,1.5,0.0,0.0,3.0,2130,0,1914,1993,955500.0,Seattle,98146,2130
2.0,1.0,2060,8398,1.0,0.0,0.0,3.0,1260,800,1962,2003,270000.0,LakeForestPark,98155,2060
3.0,1.0,1050,8498,1.0,0.0,0.0,3.0,1050,0,1958,2004,205000.0,Bellevue,98004,1050
3.0,1.0,1640,12384,1.0,0.0,0.0,4.0,1090,550,1954,1979,253500.0,FederalWay,98023,1640
3.0,2.0,960,9380,1.0,0.0,0.0,3.0,960,0,1949,1998,210000.0,Sammamish,98074,960
4.0,4.0,3360,9767,2.0,0.0,0.0,3.0,2450,910,1990,2009,412000.0,Snoqualmie,98065,3360
3.0,1.0,990,10723,1.0,0.0,0.0,5.0,990,0,1960,0,284950.0,Seattle,98144,990
4.0,2.0,2420,7927,1.0,0.0,0.0,4.0,1400,1020,1973,0,400000.0,Seattle,98115,2420
5.0,2.0,2140,7910,1.0,0.0,0.0,3.0,1070,1070,1962,2003,530000.0,Seattle,98118,2140
2.0,2.0,1090,4000,1.0,0.0,0.0,3.0,970,120,1951,1994,460000.0,LakeForestPark,98155,1090
3.0,2.0,1560,9788,1.0,0.0,0.0,3.0,1560,0,1964,2000,291000.0,Seattle,98117,1560
3.0,2.0,1700,8432,1.0,0.0,0.0,3.0,1230,470,1977,2004,475000.0,Seattle,98116,1700
3.0,2.0,1370,8719,1.0,0.0,0.0,3.0,1370,0,1982,0,247200.0,Renton,98059,1370
3.0,1.0,1150,11802,1.0,0.0,0.0,4.0,1150,0,1932,1958,346500.0,Duvall,98019,1150
4.0,3.0,1930,3031,1.0,0.0,0.0,3.0,1200,730,2006,0,330675.0,Issaquah,98027,1930
2.0,1.0,780,6685,1.0,0.0,0.0,4.0,780,0,1948,0,87500.0,Seattle,98106,780
5.0,2.0,1940,6654,1.5,0.0,0.0,4.0,1940,0,1953,1983,359000.0,Kirkland,98034,1940
3.0,2.0,1660,15600,2.0,0.0,0.0,3.0,1660,0,1981,2013,220000.0,Auburn,98001,1660
4.0,2.0,2650,11520,2.0,0.0,0.0,3.0,2110,540,1988,2000,720000.0,FederalWay,98023,2650
3.0,3.0,3700,10375,2.0,0.0,0.0,3.0,3700,0,1982,0,489000.0,Seattle,98119,3700
3.0,2.0,3480,7800,1.0,0.0,0.0,4.0,1750,1730,1941,1998,950000.0,Seattle,98119,3480
2.0,1.0,1470,7137,1.0,0.0,0.0,3.0,1020,450,1941,1994,458663.8889,Seattle,98103,1470
2.0,2.0,2290,3507,2.0,0.0,0.0,3.0,2290,0,2005,0,630000.0,Redmond,98053,2290
5.0,2.0,2190,9072,1.0,0.0,0.0,5.0,1110,1080,1965,0,600000.0,Seattle,98106,2190
2.0,1.0,900,5220,1.0,0.0,0.0,4.0,900,0,1956,0,329950.0,Seattle,98136,900
3.0,2.0,1960,12476,2.0,0.0,0.0,4.0,1960,0,1989,0,560000.0,LakeForestPark,98155,1960
2.0,1.0,650,5400,1.0,0.0,0.0,3.0,650,0,1950,2005,295000.0,Kent,98031,650
3.0,2.0,2610,5544,1.5,0.0,0.0,3.0,1680,930,1934,1978,750000.0,Woodinville,98072,2610
2.0,1.0,1250,3825,1.0,0.0,0.0,3.0,850,400,1929,0,459500.0,Covington,98042,1250
5.0,3.0,3500,5040,2.0,0.0,2.0,3.0,2950,550,1927,2007,970000.0,NorthBend,98045,3500
3.0,2.0,2630,5827,2.0,0.0,0.0,3.0,2630,0,2001,0,610000.0,Seattle,98125,2630
4.0,4.0,3450,7832,2.0,0.0,0.0,3.0,3450,0,2007,0,1050000.0,Bellevue,98008,3450
5.0,3.0,3831,13800,2.0,1.0,4.0,3.0,3831,0,1959,1980,542500.0,Renton,98058,3831
4.0,2.0,3250,4500,2.0,0.0,0.0,3.0,3250,0,2009,0,460886.9231,Redmond,98052,3250
4.0,2.0,2240,9826,1.0,0.0,0.0,4.0,1370,870,1988,0,220000.0,Seattle,98112,2240
3.0,2.0,2910,10204,2.0,0.0,0.0,3.0,2910,0,1990,2009,770000.0,Bothell,98011,2910
4.0,2.0,1780,6000,2.0,0.0,0.0,3.0,1780,0,1991,0,175000.0,Bellevue,98006,1780
4.0,3.0,2500,5801,1.5,0.0,0.0,3.0,1960,540,1926,2003,1036200.0,Seattle,98103,2500
3.0,1.0,1270,8400,1.0,0.0,0.0,3.0,1270,0,1955,2005,347000.0,Seattle,98118,1270
4.0,4.0,3370,5000,2.0,0.0,2.0,3.0,2470,900,2008,0,900000.0,Seattle,98126,3370
4.0,3.0,2250,7412,1.0,0.0,0.0,4.0,1480,770,1975,0,345000.0,Seattle,98125,2250
5.0,3.0,3110,12429,1.0,0.0,0.0,3.0,1790,1320,1977,2004,436500.0,Shoreline,98155,3110
3.0,2.0,1640,7437,1.0,0.0,0.0,3.0,1090,550,1948,1994,556000.0,Seattle,98122,1640
3.0,2.0,1270,4800,1.0,0.0,0.0,3.0,1270,0,1952,2014,415000.0,Seattle,98112,1270
3.0,2.0,2950,12196,2.0,0.0,0.0,4.0,2310,640,1918,1974,495000.0,FederalWay,98023,2950
3.0,2.0,1730,9000,1.0,0.0,0.0,3.0,1370,360,1978,0,430000.0,Seattle,98125,1730
4.0,2.0,2600,6390,1.0,0.0,0.0,3.0,1390,1210,1978,0,245000.0,MercerIsland,98040,2600
4.0,2.0,1830,7345,1.0,0.0,0.0,4.0,1540,290,1973,0,494000.0,Renton,98058,1830
3.0,1.0,1560,7552,1.0,0.0,0.0,4.0,910,650,1948,0,282508.8889,Seattle,98118,1560
3.0,1.0,1000,19204,1.0,0.0,0.0,3.0,1000,0,1968,2010,249000.0,Seattle,98115,1000
4.0,2.0,2210,9371,2.0,0.0,0.0,4.0,2210,0,1968,0,305000.0,MapleValley,98038,2210
3.0,2.0,1610,7223,2.0,0.0,0.0,3.0,1610,0,1994,0,210614.2857,Seattle,98103,1610
3.0,2.0,2110,4038,2.0,0.0,0.0,4.0,2110,0,1989,0,355000.0,Issaquah,98029,2110
4.0,2.0,1690,4080,1.0,0.0,0.0,4.0,870,820,1984,0,385000.0,Seattle,98112,1690
4.0,2.0,2480,16360,1.0,0.0,0.0,5.0,1510,970,1959,0,560000.0,Seattle,98112,2480
3.0,2.0,1400,1312,3.5,0.0,0.0,3.0,1400,0,2007,0,563500.0,Seattle,98178,1400
3.0,4.0,1590,1102,3.0,0.0,0.0,3.0,1590,0,2010,0,518500.0,Auburn,98002,1590
4.0,2.0,3500,7048,2.0,0.0,0.0,3.0,3500,0,2005,0,780000.0,Tukwila,98168,3500
4.0,2.0,2980,8051,1.5,0.0,2.0,4.0,2020,960,1935,0,535000.0,Snoqualmie,98065,2980
2.0,2.0,1060,1209,2.0,0.0,0.0,3.0,940,120,2006,0,505000.0,Redmond,98052,1060
4.0,2.0,1960,7950,1.0,0.0,0.0,4.0,1960,0,1967,0,285500.0,DesMoines,98198,1960
4.0,2.0,2590,8483,2.0,0.0,0.0,3.0,2590,0,1991,0,368112.5,Shoreline,98155,2590
3.0,2.0,1940,5980,1.0,0.0,0.0,3.0,1520,420,1987,2000,580000.0,Kirkland,98033,1940
5.0,2.0,2480,12070,2.0,0.0,0.0,3.0,2480,0,1978,0,615000.0,Seattle,98103,2480
3.0,2.0,2280,2502,2.0,0.0,0.0,3.0,1880,400,2006,0,567500.0,Seattle,98118,2280
3.0,1.0,1480,7284,1.0,0.0,0.0,3.0,970,510,1963,2008,336500.0,Seattle,98119,1480
3.0,2.0,1300,7200,1.0,0.0,0.0,5.0,1300,0,1960,0,625000.0,Auburn,98002,1300
4.0,2.0,2020,5501,2.0,0.0,0.0,3.0,2020,0,2010,0,415000.0,MapleValley,98038,2020
3.0,2.0,2560,14680,1.0,0.0,0.0,3.0,1330,1230,1987,2000,599000.0,Seattle,98117,2560
5.0,4.0,2800,7350,2.0,0.0,0.0,3.0,2800,0,1995,0,379900.0,Sammamish,98074,2800
4.0,1.0,1290,5000,1.5,0.0,0.0,3.0,1290,0,1957,2000,173666.6667,Bellevue,98004,1290
4.0,2.0,2192,12128,2.0,0.0,0.0,3.0,2192,0,2006,0,132250.0,Seattle,98125,2192
4.0,3.0,2110,8751,1.0,0.0,0.0,3.0,1510,600,1962,2003,435000.0,Newcastle,98059,2110
2.0,1.0,1320,8380,1.0,0.0,0.0,3.0,1320,0,1953,0,447000.0,Issaquah,98027,1320
4.0,3.0,3610,8580,2.0,0.0,0.0,3.0,3610,0,2014,0,982000.0,Kirkland,98033,3610
5.0,2.0,1890,5000,1.5,0.0,0.0,3.0,1090,800,1906,2014,523460.0,Seattle,98115,1890
4.0,2.0,2120,9786,1.0,0.0,0.0,3.0,1640,480,1967,2011,492650.0,Bothell,98011,2120
4.0,2.0,2580,5476,2.0,0.0,0.0,3.0,2580,0,2005,0,354000.0,Renton,98059,2580
3.0,2.0,1140,10400,1.0,0.0,0.0,4.0,1140,0,1983,0,250000.0,Snoqualmie,98065,1140
3.0,2.0,2040,6000,1.0,0.0,0.0,5.0,1120,920,1958,0,555000.0,Seattle,98125,2040
3.0,2.0,1730,6368,2.0,0.0,0.0,3.0,1730,0,1993,0,315000.0,Kirkland,98034,1730
3.0,2.0,2200,9840,1.0,0.0,0.0,5.0,1500,700,1978,0,689000.0,Kent,98031,2200
3.0,2.0,1490,4400,1.5,0.0,0.0,4.0,1490,0,1906,1990,670000.0,Seattle,98117,1490
5.0,2.0,2570,13054,1.0,0.0,1.0,3.0,1470,1100,1950,1992,519000.0,Seattle,98144,2570
4.0,3.0,2880,4000,1.5,0.0,0.0,3.0,2100,780,1912,2000,755000.0,Seattle,98118,2880
3.0,1.0,1580,6300,1.0,0.0,0.0,3.0,1180,400,1925,2002,535000.0,Seattle,98106,1580
4.0,2.0,2330,5000,1.5,0.0,0.0,4.0,1510,820,1929,0,687500.0,Seattle,98125,2330
3.0,2.0,1150,8450,1.0,0.0,0.0,4.0,1150,0,1951,1999,265950.0,Seattle,98122,1150
3.0,2.0,3170,12750,2.0,0.0,0.0,3.0,2360,810,1995,0,405000.0,Kent,98030,3170
3.0,2.0,1410,1287,2.0,0.0,0.0,3.0,1290,120,2005,0,379500.0,Bellevue,98008,1410
4.0,2.0,1860,5040,1.5,0.0,0.0,5.0,1860,0,1920,0,215000.0,Seattle,98115,1860
3.0,2.0,3040,7232,2.0,0.0,0.0,3.0,3040,0,2003,0,330000.0,Kirkland,98034,3040
4.0,1.0,1920,13787,1.0,0.0,0.0,4.0,1220,700,1966,0,170000.0,DesMoines,98198,1920
3.0,2.0,1500,5000,1.5,0.0,0.0,4.0,1140,360,1927,0,470000.0,Bellevue,98006,1500
2.0,2.0,1370,1221,2.0,0.0,0.0,3.0,1080,290,2008,0,446000.0,Redmond,98053,1370
3.0,1.0,1580,7424,1.0,0.0,0.0,3.0,1010,570,1962,2003,305000.0,Seattle,98117,1580
3.0,1.0,1200,7280,1.0,0.0,0.0,4.0,1200,0,1967,0,215000.0,Seattle,98117,1200
3.0,3.0,2200,7000,1.0,0.0,0.0,4.0,1280,920,1977,0,325000.0,Seattle,98126,2200
3.0,1.0,1150,4800,1.5,0.0,0.0,4.0,1150,0,1938,0,200000.0,Seattle,98144,1150
3.0,2.0,1860,8060,2.0,0.0,0.0,4.0,1860,0,1987,0,505000.0,Seattle,98106,1860
2.0,1.0,780,3475,1.0,0.0,0.0,4.0,780,0,1930,0,286000.0,Seattle,98116,780
3.0,3.0,3240,8338,2.0,0.0,0.0,3.0,3240,0,2001,0,812000.0,Renton,98059,3240
4.0,2.0,2630,16475,2.0,0.0,0.0,4.0,2630,0,1953,1983,84350.0,Woodinville,98077,2630
3.0,2.0,1880,5752,1.0,0.0,0.0,4.0,940,940,1945,0,396166.6667,Tukwila,98168,1880
2.0,1.0,630,4200,1.0,0.0,0.0,3.0,630,0,1930,1997,148000.0,Seattle,98103,630
3.0,2.0,2960,12420,1.0,0.0,2.0,4.0,1480,1480,1952,0,936000.0,Seattle,98105,2960
4.0,2.0,1880,3720,1.5,0.0,0.0,4.0,1880,0,1924,0,860000.0,Seattle,98108,1880
3.0,2.0,3230,5000,2.0,0.0,2.0,5.0,2430,800,1945,0,850000.0,DesMoines,98148,3230
4.0,4.0,4370,10860,2.0,0.0,0.0,3.0,4370,0,2008,0,1025000.0,Seattle,98118,4370
2.0,1.0,910,8155,1.0,0.0,0.0,4.0,910,0,1948,0,285000.0,Seattle,98117,910
3.0,2.0,1530,6000,2.0,0.0,0.0,4.0,1530,0,1991,0,265000.0,Duvall,98019,1530
4.0,2.0,2550,5200,2.0,0.0,0.0,3.0,2550,0,2009,0,435000.0,Redmond,98052,2550
3.0,4.0,3690,8837,2.0,0.0,0.0,3.0,3690,0,2001,0,725000.0,Sammamish,98074,3690
3.0,2.0,1300,11374,1.5,0.0,0.0,5.0,1300,0,1933,0,287000.0,MercerIsland,98040,1300
2.0,2.0,1430,923,3.0,0.0,0.0,3.0,1410,20,2008,0,485000.0,Seattle,98109,1430
3.0,2.0,1760,6723,1.0,0.0,0.0,3.0,1160,600,1958,2004,470000.0,Redmond,98053,1760
3.0,1.0,1100,8560,1.0,0.0,0.0,3.0,1100,0,1961,2004,199990.0,FederalWay,98003,1100
4.0,2.0,2300,6087,2.0,0.0,0.0,3.0,2300,0,2001,0,431000.0,Seattle,98118,2300
3.0,2.0,1230,11413,1.0,0.0,0.0,3.0,990,240,1984,0,400000.0,Seattle,98117,1230
3.0,2.0,1310,8065,1.0,0.0,0.0,4.0,1310,0,1948,0,435000.0,Seattle,98116,1310
3.0,2.0,3180,7904,1.0,0.0,0.0,3.0,1810,1370,2006,0,439000.0,Seattle,98178,3180
3.0,2.0,2300,6009,1.0,0.0,0.0,3.0,2300,0,2005,0,738500.0,Bellevue,98007,2300
2.0,2.0,1530,3503,1.0,0.0,1.0,4.0,830,700,1916,0,318000.0,Seattle,98106,1530
4.0,2.0,2496,8058,2.0,0.0,0.0,3.0,2496,0,1998,2006,661000.0,Bothell,98011,2496
4.0,3.0,2910,18700,1.0,0.0,0.0,3.0,2210,700,1957,1995,749950.0,Issaquah,98027,2910
4.0,2.0,2620,8331,2.0,0.0,0.0,3.0,2620,0,1991,0,380680.5556,MercerIsland,98040,2620
3.0,2.0,1680,2229,2.0,0.0,0.0,3.0,1680,0,2007,0,345000.0,Redmond,98052,1680
4.0,2.0,2230,4372,2.0,0.0,0.0,5.0,1540,690,1935,0,900000.0,Newcastle,98059,2230
3.0,2.0,1930,4500,2.0,0.0,0.0,3.0,1930,0,1990,2009,425000.0,Seattle,98117,1930
5.0,2.0,2500,9583,1.0,0.0,0.0,3.0,1300,1200,1979,2014,235000.0,Seattle,98126,2500
4.0,3.0,2620,18362,1.0,0.0,0.0,4.0,1870,750,1956,0,659500.0,Renton,98056,2620
4.0,2.0,2440,7350,1.0,0.0,0.0,3.0,1610,830,1978,0,330000.0,LakeForestPark,98155,2440
2.0,1.0,800,2280,1.0,0.0,0.0,5.0,800,0,1946,0,402500.0,Carnation,98014,800
2.0,1.0,1080,9435,1.0,0.0,0.0,3.0,1080,0,1958,2004,230000.0,Auburn,98002,1080
3.0,2.0,1260,8092,1.0,0.0,0.0,3.0,1260,0,1986,0,242000.0,Seattle,98103,1260
3.0,3.0,3010,1842,2.0,0.0,0.0,3.0,3010,0,2011,0,237333.3333,Seattle,98117,3010
2.0,1.0,920,8341,1.0,0.0,0.0,3.0,920,0,1939,1969,319950.0,DesMoines,98198,920
6.0,2.0,2640,3680,2.0,0.0,0.0,5.0,1760,880,1922,1956,880000.0,Bellevue,98008,2640
4.0,2.0,1890,8505,1.0,0.0,0.0,3.0,1290,600,1980,0,437000.0,Seattle,98108,1890
4.0,2.0,3160,13194,2.0,0.0,0.0,5.0,3160,0,1965,0,950100.0,Woodinville,98072,3160
4.0,3.0,3430,9870,2.0,0.0,0.0,3.0,3430,0,2014,0,749995.0,Bellevue,98006,3430
4.0,4.0,2970,14486,2.0,0.0,0.0,3.0,2340,630,1997,0,905000.0,Kirkland,98034,2970
2.0,1.0,930,7740,1.0,0.0,0.0,3.0,930,0,1924,2011,258125.0,Seattle,98116,930
2.0,2.0,800,2119,2.0,0.0,0.0,3.0,800,0,2008,0,265050.0,Kirkland,98034,800
2.0,2.0,1220,15600,1.0,0.0,0.0,3.0,1220,0,1972,2002,215500.0,Kirkland,98033,1220
3.0,2.0,1840,7412,1.0,0.0,0.0,4.0,1240,600,1976,1992,269500.0,LakeForestPark,98155,1840
2.0,2.0,1590,5136,1.5,0.0,3.0,3.0,1320,270,1927,2011,850000.0,Seattle,98126,1590
3.0,1.0,1090,6710,1.5,0.0,0.0,5.0,1090,0,1912,0,219500.0,SeaTac,98188,1090
4.0,2.0,2920,7700,2.0,0.0,0.0,3.0,2920,0,2003,0,515500.0,Renton,98056,2920
4.0,2.0,1220,9600,1.0,0.0,0.0,3.0,1220,0,1980,0,310000.0,Enumclaw,98022,1220
3.0,1.0,1240,3500,1.0,0.0,0.0,4.0,1240,0,1927,0,660000.0,Renton,98059,1240
7.0,4.0,3670,4000,2.0,0.0,1.0,3.0,2800,870,1964,2000,824000.0,Issaquah,98027,3670
4.0,3.0,3990,6637,2.0,0.0,0.0,3.0,3990,0,2003,0,825000.0,Seattle,98117,3990
3.0,4.0,3020,4082,2.0,0.0,0.0,3.0,2080,940,1954,2004,439333.3333,Bellevue,98005,3020
4.0,2.0,2160,6300,1.5,0.0,1.0,4.0,2160,0,1928,0,849000.0,Kent,98030,2160
3.0,2.0,1520,6380,1.0,0.0,0.0,3.0,790,730,1948,1994,438000.0,MapleValley,98038,1520
4.0,2.0,1620,7992,2.0,0.0,0.0,4.0,1620,0,1975,0,260000.0,Woodinville,98072,1620
4.0,2.0,1790,14690,1.0,0.0,1.0,4.0,1670,120,1960,2001,240000.0,Kenmore,98028,1790
3.0,1.0,1320,7000,1.0,0.0,0.0,4.0,1320,0,1967,0,206000.0,Seattle,98125,1320
2.0,1.0,870,5400,1.0,0.0,0.0,3.0,870,0,1950,2007,310000.0,Seattle,98125,870
4.0,4.0,2690,6164,2.0,0.0,0.0,3.0,2690,0,2002,0,699850.0,Seattle,98107,2690
4.0,2.0,1870,6000,1.5,0.0,0.0,3.0,1870,0,1956,2001,310000.0,Seattle,98106,1870
4.0,2.0,1890,12236,1.0,0.0,0.0,3.0,1230,660,1978,0,378000.0,Sammamish,98075,1890
2.0,1.0,1080,7775,1.0,0.0,0.0,3.0,1080,0,1955,2005,345000.0,Seattle,98126,1080
2.0,1.0,930,7623,1.0,0.0,0.0,2.0,930,0,1942,0,100000.0,Bellevue,98008,930
4.0,2.0,2030,9300,1.0,0.0,0.0,4.0,2030,0,1976,1992,259950.0,DesMoines,98198,2030
4.0,2.0,2250,7526,2.0,0.0,0.0,3.0,2250,0,1989,0,440000.0,Seattle,98103,2250
1.0,1.0,720,4800,1.0,0.0,0.0,3.0,720,0,1914,1996,190000.0,Shoreline,98177,720
4.0,2.0,2170,9665,1.0,0.0,0.0,4.0,1300,870,1976,1992,488800.0,FederalWay,98023,2170
4.0,3.0,2790,5527,2.0,0.0,0.0,3.0,2790,0,2014,0,483453.0,Redmond,98052,2790
3.0,2.0,1450,4050,2.0,0.0,0.0,3.0,1450,0,2010,0,274500.0,Kirkland,98033,1450
3.0,1.0,1120,2300,1.0,0.0,0.0,4.0,820,300,1912,1989,552000.0,Kirkland,98034,1120
3.0,2.0,2590,18980,1.0,0.0,0.0,4.0,2590,0,1976,1992,396500.0,Seattle,98107,2590
4.0,4.0,2960,6000,2.0,0.0,0.0,3.0,2960,0,2014,0,633634.0,Seattle,98105,2960
3.0,1.0,1150,7156,1.0,0.0,0.0,4.0,1150,0,1953,1983,203000.0,Seattle,98108,1150
3.0,2.0,1480,8394,1.0,0.0,0.0,4.0,1480,0,1971,0,450000.0,Shoreline,98177,1480
3.0,2.0,1700,11475,1.0,0.0,0.0,5.0,970,730,1945,0,225000.0,Seattle,98115,1700
3.0,1.0,1080,6000,1.0,0.0,0.0,4.0,1080,0,1952,0,275000.0,Seattle,98144,1080
2.0,1.0,2160,12960,1.0,0.0,0.0,3.0,1360,800,1968,1997,305000.0,SeaTac,98188,2160
4.0,1.0,1360,6000,1.5,0.0,0.0,3.0,1360,0,1917,2009,511500.0,Renton,98059,1360
2.0,1.0,770,4840,1.0,0.0,0.0,4.0,770,0,1927,0,275000.0,Kent,98032,770
3.0,2.0,1830,9848,1.0,0.0,0.0,5.0,1830,0,1962,0,468000.0,Issaquah,98029,1830
3.0,2.0,2270,11989,1.0,0.0,0.0,4.0,2270,0,1968,0,815000.0,Sammamish,98075,2270
4.0,2.0,2030,9600,1.5,0.0,0.0,3.0,1430,600,1947,2012,253779.0,NorthBend,98045,2030
4.0,2.0,2040,8400,1.0,0.0,0.0,3.0,1420,620,1963,2008,500000.0,Redmond,98052,2040
3.0,1.0,1110,8593,1.0,0.0,0.0,3.0,1110,0,1979,2014,299900.0,Redmond,98052,1110
2.0,3.0,2700,8572,1.0,0.0,0.0,3.0,2700,0,2007,0,810000.0,Redmond,98052,2700
3.0,2.0,1300,3731,1.0,0.0,0.0,3.0,900,400,1993,0,450385.7143,Seattle,98133,1300
4.0,1.0,1230,7410,1.5,0.0,0.0,3.0,1230,0,1944,0,252750.0,Redmond,98052,1230
2.0,1.0,1980,5000,1.0,0.0,0.0,4.0,1090,890,1923,0,496752.0,Seattle,98126,1980
3.0,2.0,1500,7200,1.0,0.0,0.0,3.0,1500,0,1957,2000,360000.0,Seattle,98112,1500
4.0,2.0,3290,6628,2.0,0.0,0.0,3.0,3290,0,2003,0,715000.0,Redmond,98052,3290
3.0,2.0,1420,1192,2.0,0.0,0.0,3.0,1140,280,2008,0,345000.0,Bellevue,98006,1420
3.0,2.0,1540,3000,1.0,0.0,2.0,3.0,770,770,1920,1979,512031.0,Redmond,98053,1540
4.0,2.0,2630,6185,2.0,0.0,0.0,3.0,2630,0,1999,0,585000.0,Seattle,98108,2630
5.0,2.0,2900,10300,1.0,0.0,0.0,3.0,1450,1450,1985,0,675000.0,Bellevue,98006,2900
3.0,1.0,1800,7650,1.0,0.0,0.0,5.0,1800,0,1957,0,265000.0,Burien,98166,1800
3.0,2.0,1050,6150,1.5,0.0,0.0,4.0,950,100,1928,0,400000.0,Renton,98059,1050
4.0,2.0,2280,5000,2.0,0.0,0.0,3.0,2280,0,2006,0,345000.0,Kirkland,98034,2280
3.0,1.0,1140,8366,1.0,0.0,0.0,5.0,1140,0,1943,0,171224.8,Redmond,98052,1140
4.0,2.0,2040,5523,2.0,0.0,0.0,3.0,2040,0,1999,0,345000.0,Woodinville,98072,2040
4.0,2.0,2190,4080,2.0,0.0,0.0,3.0,1800,390,1918,0,855000.0,Kent,98031,2190
4.0,2.0,1950,2617,1.5,0.0,0.0,4.0,1250,700,1910,0,519000.0,Kent,98030,1950
2.0,2.0,1200,1687,3.0,0.0,0.0,3.0,1200,0,2008,0,504200.0,Seattle,98199,1200
2.0,1.0,890,2100,1.0,0.0,0.0,4.0,760,130,1919,1985,460000.0,Seattle,98117,890
5.0,3.0,2510,9180,1.0,0.0,1.0,4.0,1600,910,1975,0,695500.0,Renton,98058,2510
3.0,2.0,1730,7416,1.5,0.0,0.0,3.0,1730,0,1954,2005,355000.0,MapleValley,98038,1730
3.0,2.0,1980,2674,3.0,0.0,0.0,3.0,1980,0,2007,0,435000.0,Bellevue,98004,1980
3.0,3.0,2850,14800,1.0,0.0,0.0,4.0,1920,930,1976,1992,775000.0,Burien,98168,2850
4.0,2.0,1990,5948,2.0,0.0,0.0,3.0,1990,0,1991,0,536000.0,Auburn,98001,1990
2.0,1.0,860,6600,1.0,0.0,0.0,5.0,860,0,1949,0,200000.0,Woodinville,98072,860
3.0,3.0,3890,7216,2.0,0.0,1.0,3.0,3260,630,1967,2010,1080000.0,Seattle,98125,3890
3.0,2.0,1140,1201,2.0,0.0,0.0,3.0,1140,0,2014,0,230000.0,Covington,98042,1140
2.0,1.0,870,11100,1.0,0.0,0.0,3.0,870,0,1940,1996,234000.0,Auburn,98092,870
3.0,1.0,1040,8892,1.0,0.0,0.0,4.0,800,240,1958,1972,182805.0,Bothell,98011,1040
6.0,4.0,3120,4240,2.0,0.0,2.0,4.0,2090,1030,1993,0,315000.0,MercerIsland,98040,3120
4.0,2.0,2010,7688,1.0,0.0,0.0,3.0,1170,840,1979,2014,229000.0,Kent,98031,2010
3.0,3.0,1850,16960,1.0,0.0,2.0,4.0,1850,0,1953,1983,645000.0,Seattle,98199,1850
3.0,2.0,1480,3876,1.0,0.0,0.0,5.0,860,620,1928,1970,663000.0,Renton,98058,1480
3.0,2.0,1880,10032,1.0,0.0,0.0,4.0,1880,0,1984,0,486445.8333,Seattle,98144,1880
3.0,1.0,1890,3330,1.5,0.0,0.0,4.0,1390,500,1901,0,486895.0,Seattle,98168,1890
3.0,2.0,2370,5353,2.0,0.0,0.0,3.0,2370,0,2009,0,429900.0,SeaTac,98188,2370
3.0,2.0,1380,4800,1.0,0.0,0.0,3.0,1380,0,1948,1994,640000.0,Kenmore,98028,1380
4.0,2.0,1450,8400,1.5,0.0,0.0,4.0,1450,0,1962,0,440000.0,Auburn,98001,1450
4.0,3.0,2240,8504,2.0,0.0,0.0,3.0,2240,0,1992,0,337000.0,Seattle,98116,2240
2.0,1.0,1060,3040,1.0,0.0,0.0,3.0,860,200,1924,2011,480000.0,Shoreline,98133,1060
4.0,2.0,2030,8426,2.0,0.0,0.0,3.0,2030,0,1944,0,275000.0,Newcastle,98059,2030
4.0,2.0,3160,8281,2.0,0.0,0.0,4.0,3160,0,1995,0,1127000.0,Redmond,98052,3160
3.0,2.0,1470,4653,2.0,0.0,0.0,4.0,1470,0,1985,0,455000.0,Issaquah,98027,1470
4.0,2.0,2490,5170,2.0,0.0,0.0,4.0,2490,0,2000,0,725000.0,LakeForestPark,98155,2490
5.0,2.0,2130,4180,1.5,0.0,0.0,5.0,1270,860,1926,0,615000.0,Seattle,98103,2130
1.0,1.0,590,833,1.0,0.0,0.0,4.0,590,0,1926,1993,202000.0,Kent,98042,590
2.0,1.0,1740,5719,1.0,0.0,0.0,3.0,1740,0,1955,2005,800000.0,Shoreline,98133,1740
3.0,2.0,2220,17568,1.0,0.0,0.0,4.0,2220,0,1967,0,437000.0,Redmond,98052,2220
3.0,2.0,1800,2700,2.0,0.0,0.0,3.0,1800,0,2011,0,309000.0,Seattle,98177,1800
7.0,3.0,2800,9569,1.0,0.0,2.0,3.0,1400,1400,1963,2008,350000.0,Seattle,98126,2800
2.0,2.0,1130,746,2.0,0.0,0.0,3.0,1030,100,2009,0,536000.0,Renton,98058,1130
2.0,2.0,1330,10838,2.0,0.0,0.0,3.0,1330,0,1985,0,355000.0,Renton,98058,1330
4.0,2.0,2610,8031,2.0,0.0,0.0,3.0,2610,0,1998,2006,510000.0,Covington,98042,2610
4.0,4.0,3990,5267,2.0,0.0,0.0,3.0,3990,0,2008,0,1080000.0,Newcastle,98056,3990
3.0,2.0,1950,5689,2.0,0.0,0.0,3.0,1950,0,2009,0,425000.0,MercerIsland,98040,1950
3.0,2.0,1840,9900,1.0,0.0,0.0,3.0,1840,0,1978,0,552000.0,Seattle,98112,1840
2.0,1.0,1440,3700,1.0,0.0,0.0,3.0,1200,240,1914,1996,562100.0,Seattle,98125,1440
4.0,4.0,4260,9800,2.0,0.0,0.0,3.0,4260,0,2008,0,1065000.0,Renton,98055,4260
3.0,2.0,1300,14350,1.0,0.0,0.0,3.0,1300,0,1955,2013,502000.0,MercerIsland,98040,1300
4.0,2.0,2320,11717,2.0,0.0,0.0,3.0,2320,0,1997,0,397000.0,Sammamish,98074,2320
3.0,2.0,2390,7149,1.0,0.0,0.0,3.0,1350,1040,1955,2005,396500.0,Seattle,98133,2390
2.0,2.0,1670,4008,1.0,0.0,0.0,3.0,1670,0,2005,0,565000.0,Issaquah,98029,1670
2.0,1.0,940,5040,1.0,0.0,0.0,3.0,940,0,1926,2003,212700.0,Redmond,98053,940
4.0,2.0,1660,8063,1.0,0.0,0.0,4.0,1660,0,1978,2000,270000.0,Kirkland,98033,1660
5.0,2.0,2640,7096,2.0,0.0,0.0,3.0,2640,0,2003,0,632500.0,Kirkland,98033,2640
3.0,2.0,1300,907,2.0,0.0,0.0,3.0,1000,300,2006,0,562500.0,Seattle,98146,1300
6.0,2.0,1670,3000,1.0,0.0,0.0,5.0,900,770,1911,1984,680000.0,Bothell,98011,1670
4.0,2.0,2790,7938,2.0,0.0,0.0,3.0,2790,0,1997,0,764000.0,Seattle,98119,2790
4.0,2.0,1220,10580,1.0,0.0,0.0,3.0,1220,0,1965,1993,418000.0,Redmond,98052,1220
4.0,3.0,2520,14021,2.0,0.0,0.0,3.0,2520,0,1999,0,234975.0,Seattle,98119,2520
3.0,2.0,3280,10302,1.0,0.0,0.0,3.0,1680,1600,1970,2014,1075000.0,Seattle,98108,3280
3.0,2.0,1440,9220,1.0,0.0,0.0,3.0,1440,0,1965,1993,250000.0,FederalWay,98023,1440
5.0,2.0,2980,5377,2.0,0.0,0.0,3.0,2980,0,2006,0,739900.0,Seattle,98122,2980
4.0,2.0,1830,8734,2.0,0.0,0.0,4.0,1830,0,1991,0,132250.0,FederalWay,98003,1830
5.0,4.0,3500,10155,2.0,0.0,0.0,3.0,2570,930,1996,0,905000.0,Kent,98031,3500
1.0,2.0,1150,9812,1.0,0.0,0.0,4.0,1150,0,1962,0,115000.0,Seattle,98117,1150
3.0,2.0,1170,8182,1.0,0.0,0.0,3.0,1170,0,1962,2003,352500.0,Burien,98148,1170
4.0,1.0,1410,3376,1.5,0.0,0.0,5.0,1410,0,1911,1984,563000.0,Seattle,98146,1410
5.0,4.0,3990,9938,2.0,0.0,0.0,3.0,3990,0,2001,0,1068000.0,MercerIsland,98040,3990
4.0,3.0,3060,5000,2.0,0.0,0.0,3.0,3060,0,2001,0,399000.0,Seattle,98118,3060
3.0,1.0,1650,6400,1.0,0.0,0.0,4.0,980,670,1954,1979,371500.0,FederalWay,98023,1650
5.0,2.0,2360,11375,1.0,0.0,0.0,4.0,1180,1180,1962,0,317000.0,Kenmore,98028,2360
3.0,1.0,1030,9834,1.0,0.0,0.0,3.0,1030,0,1969,2010,326000.0,Enumclaw,98022,1030
3.0,1.0,890,8400,1.0,0.0,0.0,4.0,890,0,1954,1979,283000.0,Kent,98030,890
4.0,4.0,4440,10660,2.0,0.0,0.0,3.0,4440,0,2003,0,1037000.0,FederalWay,98023,4440
3.0,2.0,1230,8056,1.0,0.0,0.0,4.0,1230,0,1949,1985,150000.0,Seattle,98102,1230
4.0,2.0,2540,5001,2.0,0.0,0.0,3.0,2540,0,2005,0,487000.0,Shoreline,98155,2540
2.0,2.0,1180,9265,1.0,0.0,0.0,3.0,1180,0,1940,1996,257500.0,MercerIsland,98040,1180
3.0,2.0,1170,8740,1.0,0.0,0.0,4.0,1170,0,1968,0,440000.0,Issaquah,98027,1170
5.0,2.0,2760,8015,1.0,0.0,0.0,4.0,1600,1160,1960,2001,378000.0,Seattle,98119,2760
3.0,2.0,1770,8868,1.0,0.0,0.0,4.0,1770,0,1959,0,250000.0,Seattle,98117,1770
3.0,2.0,2000,7560,1.0,0.0,0.0,4.0,1300,700,1968,0,325187.5,Bellevue,98006,2000
2.0,1.0,1380,4390,1.0,0.0,0.0,4.0,880,500,1931,0,450000.0,Duvall,98019,1380
4.0,2.0,2950,4502,2.0,0.0,0.0,3.0,2950,0,2005,0,455000.0,LakeForestPark,98155,2950
3.0,1.0,990,8062,1.0,0.0,0.0,4.0,990,0,1960,2001,250000.0,Burien,98168,990
4.0,2.0,2840,12866,1.0,0.0,0.0,4.0,1780,1060,1977,0,729032.0,Seattle,98146,2840
4.0,3.0,3000,5470,2.0,0.0,0.0,3.0,3000,0,2005,0,355000.0,Seattle,98115,3000
4.0,2.0,1840,5419,1.0,0.0,0.0,4.0,920,920,1942,1982,639000.0,Renton,98059,1840
4.0,3.0,2610,8760,1.0,0.0,0.0,4.0,1760,850,1978,2000,762500.0,MapleValley,98038,2610
3.0,2.0,2480,5137,2.0,0.0,0.0,3.0,2480,0,2000,0,641633.3333,Sammamish,98075,2480
2.0,2.0,1494,19271,2.0,1.0,4.0,3.0,1494,0,1943,1997,465000.0,Auburn,98092,1494
3.0,2.0,1640,3896,2.0,0.0,0.0,3.0,1640,0,1994,0,478000.0,Seattle,98126,1640
3.0,2.0,1400,6956,1.0,0.0,0.0,4.0,1400,0,1957,2001,230000.0,Seattle,98144,1400
3.0,2.0,1540,10800,1.0,0.0,0.0,5.0,770,770,1947,0,500000.0,Bellevue,98006,1540
3.0,2.0,2300,13418,1.0,0.0,0.0,3.0,1430,870,1955,2005,610000.0,Seattle,98199,2300
3.0,2.0,1820,8085,2.0,0.0,0.0,3.0,1820,0,1983,2009,329950.0,Kirkland,98033,1820
3.0,2.0,1570,16817,2.0,0.0,0.0,3.0,1570,0,1982,0,370000.0,Renton,98058,1570
3.0,2.0,2200,11000,2.0,0.0,2.0,3.0,2200,0,1978,0,580000.0,Sammamish,98074,2200
4.0,2.0,1880,8800,1.0,0.0,0.0,3.0,1130,750,1960,2012,284000.0,Kenmore,98028,1880
4.0,2.0,1310,8454,1.0,0.0,0.0,4.0,1310,0,1953,1983,304000.0,Issaquah,98027,1310
4.0,2.0,3060,7140,2.0,0.0,0.0,3.0,3060,0,2006,0,826000.0,Seattle,98125,3060
3.0,1.0,1460,7200,1.0,0.0,0.0,3.0,1260,200,1906,2014,538000.0,Renton,98058,1460
5.0,2.0,2820,9375,1.0,0.0,0.0,4.0,1550,1270,1968,0,527700.0,Seattle,98122,2820
3.0,2.0,2000,9900,1.0,0.0,2.0,4.0,1480,520,1957,2001,440000.0,Seattle,98126,2000
2.0,1.0,1060,3036,1.5,0.0,0.0,4.0,1060,0,1943,0,435000.0,Shoreline,98133,1060
3.0,2.0,1870,5013,2.0,0.0,0.0,3.0,1870,0,2003,0,458000.0,Seattle,98126,1870
4.0,2.0,2520,7253,2.0,0.0,0.0,3.0,2520,0,1990,2009,442000.0,Seattle,98105,2520
3.0,2.0,1890,4838,2.0,0.0,0.0,3.0,1730,160,2002,0,269950.0,Seattle,98119,1890
2.0,2.0,1785,779,2.0,0.0,0.0,3.0,1595,190,1975,0,530000.0,Seattle,98144,1785
3.0,2.0,1780,5720,1.0,0.0,0.0,5.0,980,800,1925,0,680000.0,MapleValley,98038,1780
1.0,1.0,380,15000,1.0,0.0,0.0,3.0,380,0,1963,2008,245000.0,Seattle,98136,380
4.0,2.0,3190,11597,2.0,0.0,0.0,3.0,2300,890,1984,0,750000.0,Issaquah,98029,3190
4.0,2.0,1290,3060,2.0,0.0,0.0,4.0,1290,0,1906,1990,549000.0,Seattle,98144,1290
3.0,2.0,1410,9600,1.0,0.0,0.0,4.0,1410,0,1983,0,365500.0,Duvall,98019,1410
3.0,2.0,1180,16552,1.0,0.0,0.0,4.0,1180,0,1967,0,390000.0,Bellevue,98008,1180
3.0,2.0,1600,10280,1.0,0.0,0.0,3.0,1050,550,1977,2004,442500.0,Seattle,98106,1600
2.0,1.0,1050,2570,1.0,0.0,0.0,5.0,850,200,1927,0,430000.0,Woodinville,98072,1050
3.0,2.0,2370,4200,2.0,0.0,0.0,3.0,2370,0,2014,0,351999.0,Shoreline,98155,2370
4.0,2.0,2410,4780,2.0,0.0,0.0,3.0,2410,0,2000,0,440000.0,Sammamish,98074,2410
2.0,1.0,1000,4776,1.0,0.0,0.0,4.0,1000,0,1942,1982,247875.0,Seattle,98178,1000
4.0,3.0,2520,3360,1.5,0.0,0.0,4.0,1550,970,1931,0,618250.0,Kent,98031,2520
4.0,2.0,2400,6137,2.0,0.0,0.0,3.0,2400,0,1990,2009,575000.0,Burien,98166,2400
3.0,2.0,1510,8000,1.0,0.0,0.0,4.0,1510,0,1956,0,470000.0,Bellevue,98004,1510
4.0,2.0,2070,7500,2.0,0.0,0.0,4.0,2070,0,1977,0,417985.7143,Kirkland,98034,2070
4.0,2.0,1800,2970,1.0,0.0,0.0,4.0,1000,800,1923,0,415000.0,Seattle,98177,1800
3.0,3.0,1980,2850,3.0,0.0,0.0,3.0,1980,0,1987,2000,660000.0,Issaquah,98029,1980
4.0,1.0,1580,8475,1.5,0.0,2.0,4.0,1580,0,1928,0,406000.0,Seattle,98103,1580
3.0,2.0,2670,10496,2.0,0.0,0.0,3.0,2670,0,1989,0,657500.0,Seattle,98136,2670
5.0,2.0,2200,4080,1.5,0.0,0.0,5.0,1420,780,1916,0,547000.0,Seattle,98144,2200
4.0,3.0,2440,9664,2.0,0.0,0.0,3.0,1890,550,1981,2013,480000.0,Renton,98057,2440
2.0,1.0,940,9839,1.0,0.0,0.0,3.0,940,0,1910,2006,337945.75,Seattle,98117,940
4.0,2.0,2410,8400,2.0,0.0,0.0,5.0,2410,0,1965,0,720000.0,Auburn,98002,2410
2.0,1.0,740,7680,1.0,0.0,0.0,4.0,740,0,1922,0,350000.0,MercerIsland,98040,740
3.0,2.0,1770,17208,1.0,0.0,0.0,3.0,1160,610,1959,1989,254000.0,Seattle,98119,1770
3.0,2.0,1910,2091,2.0,0.0,0.0,3.0,1910,0,2014,0,494815.0,Seattle,98199,1910
3.0,2.0,1200,6240,1.0,0.0,0.0,3.0,1030,170,1952,2008,718500.0,Covington,98042,1200
6.0,3.0,2840,8346,1.0,0.0,0.0,5.0,1420,1420,1961,0,665000.0,Woodinville,98072,2840
5.0,2.0,2280,19000,1.5,0.0,0.0,3.0,2280,0,1924,2011,365000.0,Issaquah,98029,2280
3.0,2.0,1715,6819,2.0,0.0,0.0,3.0,1715,0,1995,0,257500.0,Seattle,98119,1715
3.0,1.0,1770,5720,1.5,0.0,0.0,4.0,1140,630,1926,1993,373000.0,Renton,98059,1770
3.0,2.0,1880,3800,1.0,0.0,0.0,5.0,1030,850,1927,0,667500.0,Seattle,98103,1880
3.0,2.0,2320,2267,3.0,0.0,0.0,3.0,2320,0,2009,0,425000.0,Renton,98059,2320
3.0,2.0,2390,1984,2.0,0.0,0.0,3.0,2220,170,2008,0,629800.0,Seattle,98103,2390
3.0,2.0,1780,10395,1.0,0.0,0.0,3.0,1780,0,1967,2011,300000.0,Sammamish,98074,1780
2.0,1.0,1500,6685,1.0,0.0,0.0,3.0,1190,310,1926,2003,245000.0,FederalWay,98023,1500
2.0,2.0,1090,934,3.0,0.0,0.0,3.0,1090,0,2008,0,427500.0,Shoreline,98155,1090
3.0,2.0,1820,5000,1.5,0.0,0.0,4.0,1720,100,1941,1998,750000.0,DesMoines,98198,1820
3.0,1.0,1330,5412,2.0,0.0,0.0,5.0,1330,0,1905,0,197500.0,Shoreline,98177,1330
3.0,4.0,1890,1710,2.0,0.0,0.0,3.0,1640,250,1999,0,587206.0,Renton,98056,1890
5.0,3.0,3130,12087,2.0,0.0,0.0,3.0,2180,950,1975,0,500000.0,Seattle,98122,3130
3.0,2.0,1601,2491,3.0,0.0,0.0,3.0,1536,65,2007,0,378000.0,Seattle,98117,1601
2.0,2.0,1780,2067,2.0,0.0,0.0,5.0,1780,0,1974,0,935000.0,Seattle,98119,1780
6.0,3.0,2180,7956,2.0,0.0,0.0,3.0,2180,0,1980,0,235000.0,Seattle,98109,2180
2.0,2.0,2770,7781,2.0,0.0,0.0,3.0,2770,0,2006,0,754800.0,Medina,98039,2770
3.0,1.0,1070,8179,1.0,0.0,0.0,3.0,1070,0,1949,1998,210000.0,LakeForestPark,98155,1070
4.0,3.0,2950,15540,1.0,0.0,0.0,4.0,2120,830,1974,0,402000.0,Auburn,98092,2950
4.0,3.0,2720,4613,2.0,0.0,0.0,3.0,2720,0,2005,0,594000.0,Seattle,98125,2720
3.0,2.0,1240,11172,1.0,0.0,0.0,3.0,1000,240,1984,0,401000.0,Renton,98059,1240
4.0,2.0,2105,6093,2.0,0.0,0.0,3.0,2105,0,2003,0,330000.0,ClydeHill,98004,2105
5.0,2.0,1650,3000,1.5,0.0,0.0,3.0,1650,0,1902,0,443000.0,Kirkland,98034,1650
4.0,3.0,2530,14178,2.0,0.0,0.0,3.0,2530,0,1997,0,469950.0,Kirkland,98033,2530
4.0,1.0,1440,3600,1.5,0.0,0.0,4.0,1440,0,1924,0,550000.0,Bellevue,98008,1440
3.0,2.0,1220,7300,1.0,0.0,0.0,3.0,1220,0,1973,2013,175000.0,Seattle,98115,1220
5.0,4.0,3100,10200,1.0,0.0,4.0,3.0,1660,1440,1970,2014,905000.0,Kirkland,98034,3100
3.0,1.0,1140,4200,2.0,0.0,0.0,4.0,1140,0,1904,0,345000.0,Shoreline,98155,1140
4.0,2.0,2210,7079,2.0,0.0,0.0,3.0,2210,0,1993,0,382500.0,Issaquah,98075,2210
4.0,2.0,1910,7683,2.0,0.0,0.0,3.0,1910,0,1987,2000,620000.0,Auburn,98001,1910
4.0,2.0,2110,12653,2.0,0.0,0.0,4.0,2110,0,1972,0,672500.0,Seattle,98146,2110
2.0,1.0,1500,4120,1.5,0.0,0.0,3.0,880,620,1928,1954,156766.6667,FederalWay,98023,1500
4.0,2.0,2150,9000,1.0,0.0,0.0,4.0,1110,1040,1966,0,550000.0,Kent,98031,2150
3.0,2.0,1490,1036,2.0,0.0,0.0,3.0,1090,400,2008,0,584000.0,Seattle,98117,1490
4.0,2.0,2600,7200,2.0,0.0,0.0,3.0,2600,0,1962,2002,691500.0,Seattle,98199,2600
3.0,2.0,1490,4522,2.0,0.0,0.0,3.0,1490,0,2009,0,326983.3333,Shoreline,98155,1490
4.0,3.0,2250,3433,1.5,0.0,0.0,3.0,1500,750,1927,2013,1050000.0,Seattle,98116,2250
3.0,2.0,1840,5000,1.5,0.0,0.0,5.0,1340,500,1915,0,750000.0,Seattle,98115,1840
6.0,1.0,1370,5080,1.5,0.0,0.0,3.0,1120,250,1931,0,175000.0,Seattle,98112,1370
4.0,3.0,2370,3672,1.5,0.0,0.0,5.0,1650,720,1916,0,471500.0,Issaquah,98029,2370
4.0,2.0,2050,6360,2.0,0.0,0.0,3.0,2050,0,1988,2000,530000.0,Kirkland,98033,2050
3.0,1.0,1450,7200,1.0,0.0,0.0,3.0,1010,440,1969,2010,306000.0,MercerIsland,98040,1450
2.0,1.0,1500,3420,1.0,0.0,0.0,3.0,1500,0,1902,0,480000.0,SeaTac,98168,1500
2.0,2.0,1500,8645,1.0,0.0,0.0,4.0,1500,0,1963,0,249500.0,Kirkland,98033,1500
2.0,2.0,1210,1040,2.0,0.0,0.0,3.0,1210,0,2014,0,357186.0,Issaquah,98029,1210
4.0,4.0,3280,6603,2.0,0.0,0.0,3.0,3280,0,2007,0,963000.0,Burien,98148,3280
3.0,1.0,1180,5002,1.5,0.0,0.0,3.0,1180,0,1946,0,282508.8889,Kent,98031,1180
2.0,1.0,970,4560,1.0,0.0,0.0,4.0,970,0,1907,0,690000.0,Kirkland,98034,970
4.0,2.0,1600,9289,1.0,0.0,0.0,4.0,1600,0,1959,0,224000.0,Seattle,98112,1600
3.0,2.0,1150,887,3.0,0.0,0.0,3.0,1150,0,2007,0,360500.0,Shoreline,98155,1150
4.0,2.0,2070,5415,2.0,0.0,0.0,3.0,2070,0,1996,0,578000.0,Bellevue,98006,2070
4.0,2.0,3000,10392,2.0,0.0,0.0,3.0,3000,0,1995,0,740000.0,Snoqualmie,98065,3000
3.0,3.0,2630,4896,2.0,0.0,0.0,3.0,2630,0,2006,0,738000.0,Kenmore,98028,2630
3.0,2.0,2450,12497,1.0,0.0,0.0,4.0,2450,0,1967,0,358000.0,Auburn,98001,2450
3.0,2.0,1500,13430,1.0,0.0,0.0,3.0,1500,0,1977,2004,383000.0,MercerIsland,98040,1500
3.0,2.0,1840,5000,1.0,0.0,0.0,4.0,920,920,1910,0,499000.0,Renton,98056,1840
3.0,1.0,1060,7473,1.0,0.0,0.0,3.0,1060,0,1959,1989,140000.0,Redmond,98053,1060
3.0,2.0,1780,7280,1.0,0.0,2.0,3.0,1340,440,1972,2002,449500.0,Kent,98042,1780
4.0,2.0,2230,8624,1.0,0.0,0.0,4.0,1430,800,1969,0,565000.0,Auburn,98001,2230
3.0,2.0,1530,3210,1.5,0.0,0.0,5.0,1010,520,1928,1970,558653.8462,Seattle,98199,1530
4.0,2.0,2940,10382,2.0,0.0,0.0,4.0,2940,0,1991,0,752000.0,Bellevue,98007,2940
3.0,2.0,1380,4500,1.0,0.0,0.0,5.0,1380,0,1960,0,650000.0,Auburn,98002,1380
3.0,2.0,1720,7885,2.0,0.0,0.0,3.0,1720,0,1983,2009,290256.0,Seattle,98108,1720
2.0,1.0,900,3400,1.0,0.0,0.0,5.0,900,0,1905,0,191000.0,Seattle,98107,900
4.0,2.0,2570,5250,2.0,0.0,0.0,3.0,2570,0,1990,2009,561000.0,Seattle,98119,2570
4.0,2.0,1920,7700,2.0,0.0,0.0,4.0,1920,0,1970,0,415000.0,Kent,98042,1920
3.0,2.0,2010,10760,2.0,0.0,0.0,3.0,2010,0,1985,0,605000.0,Enumclaw,98022,2010
2.0,1.0,880,6413,1.0,0.0,0.0,3.0,880,0,1950,2005,379509.1667,Seattle,98112,880
3.0,3.0,1384,1287,2.0,0.0,0.0,3.0,1144,240,2006,0,575000.0,Redmond,98053,1384
4.0,2.0,2420,7672,1.0,0.0,0.0,3.0,1480,940,1979,2014,257500.0,Renton,98058,2420
3.0,2.0,2420,7307,2.0,0.0,0.0,3.0,2420,0,1998,2006,482000.0,Issaquah,98029,2420
3.0,2.0,1530,2913,2.0,0.0,0.0,4.0,1530,0,1986,0,379000.0,Seattle,98103,1530
2.0,1.0,900,2910,1.0,0.0,0.0,5.0,900,0,1924,1956,381500.0,Issaquah,98029,900
3.0,1.0,2710,19000,2.0,0.0,3.0,4.0,2710,0,1950,1983,410000.0,Issaquah,98029,2710
3.0,2.0,1230,7420,1.5,0.0,0.0,5.0,1230,0,1913,0,200000.0,Covington,98042,1230
3.0,2.0,1420,1282,3.0,0.0,0.0,3.0,1420,0,2006,0,523950.0,Seattle,98168,1420
4.0,2.0,3140,10437,1.0,0.0,0.0,4.0,2040,1100,1959,0,925000.0,Woodinville,98077,3140
4.0,2.0,2810,9800,1.0,0.0,0.0,4.0,1710,1100,1973,0,825000.0,Seattle,98118,2810
4.0,2.0,2340,6896,2.0,0.0,0.0,3.0,2340,0,2001,0,465950.0,Sammamish,98075,2340
4.0,2.0,3070,8400,2.0,0.0,0.0,4.0,3070,0,1970,0,600000.0,Bellevue,98006,3070
4.0,2.0,1520,7700,1.0,0.0,0.0,4.0,1520,0,1967,0,499950.0,Seattle,98103,1520
4.0,2.0,2530,8169,2.0,0.0,0.0,3.0,2530,0,1993,0,252980.0,Vashon,98070,2530
3.0,2.0,1840,3035,1.0,0.0,0.0,3.0,920,920,1926,2003,678333.3333,Renton,98059,1840
3.0,2.0,1960,6058,2.0,0.0,0.0,3.0,1960,0,2002,0,560000.0,Kirkland,98033,1960
3.0,2.0,1900,11165,1.0,0.0,0.0,4.0,1900,0,1959,0,557500.0,Bellevue,98008,1900
3.0,2.0,2140,3000,2.0,0.0,0.0,3.0,2140,0,1905,2006,780000.0,Issaquah,98029,2140
4.0,2.0,1560,7500,1.0,0.0,0.0,4.0,1560,0,1968,0,439000.0,MercerIsland,98040,1560
3.0,2.0,1440,7210,1.0,0.0,0.0,3.0,1440,0,1983,2009,210000.0,Seattle,98133,1440
3.0,2.0,1660,5128,2.0,0.0,0.0,3.0,1660,0,2001,0,300000.0,Seattle,98103,1660
3.0,2.0,1980,6250,1.0,0.0,1.0,5.0,1090,890,1910,0,440825.0,Issaquah,98027,1980
3.0,2.0,3010,7014,2.0,0.0,0.0,3.0,3010,0,2009,0,416904.1667,Seattle,98125,3010
5.0,4.0,4030,13474,2.0,0.0,0.0,3.0,4030,0,2000,0,989000.0,Snoqualmie,98065,4030
3.0,1.0,1310,9612,1.0,0.0,0.0,3.0,960,350,1962,2003,150000.0,Covington,98042,1310
3.0,2.0,2380,11824,1.0,0.0,0.0,4.0,1450,930,1972,0,800000.0,Seattle,98106,2380
3.0,2.0,1760,7482,1.0,0.0,0.0,4.0,1760,0,1966,0,264000.0,Kent,98030,1760
3.0,2.0,1880,11249,1.0,0.0,0.0,3.0,1330,550,1985,0,248400.0,Snoqualmie,98065,1880
2.0,2.0,1260,1575,2.0,0.0,0.0,3.0,1260,0,2001,0,374000.0,Burien,98148,1260
4.0,2.0,1780,5336,1.5,0.0,0.0,5.0,930,850,1918,0,315000.0,FederalWay,98003,1780
5.0,3.0,2400,8050,2.0,0.0,0.0,3.0,2400,0,1998,2006,327000.0,Seattle,98106,2400
4.0,2.0,2310,4079,2.0,0.0,0.0,3.0,2310,0,2008,0,646000.0,Redmond,98052,2310
3.0,1.0,910,10575,1.0,0.0,0.0,4.0,910,0,1968,0,190000.0,Seattle,98126,910
4.0,1.0,1720,2800,1.5,0.0,0.0,4.0,1200,520,1926,1993,547000.0,Seattle,98117,1720
3.0,2.0,2870,5000,1.5,0.0,0.0,4.0,1840,1030,1907,0,802000.0,Seattle,98115,2870
3.0,2.0,2280,7417,2.0,0.0,0.0,3.0,2280,0,1998,2006,320000.0,MapleValley,98038,2280
4.0,2.0,2090,10306,2.0,0.0,0.0,3.0,2090,0,1986,0,632500.0,Kirkland,98034,2090
2.0,2.0,1300,1676,1.0,0.0,2.0,3.0,1300,0,1943,2002,685000.0,Kirkland,98034,1300
4.0,2.0,1700,5846,1.0,0.0,0.0,3.0,1700,0,1957,2000,616000.0,Snoqualmie,98065,1700
3.0,2.0,1010,9600,1.0,0.0,0.0,5.0,1010,0,1969,0,230000.0,Seattle,98117,1010
3.0,2.0,2120,13090,1.0,0.0,0.0,3.0,2120,0,1997,0,340000.0,Seattle,98199,2120
4.0,2.0,2300,6448,2.0,0.0,0.0,3.0,2300,0,2001,0,342000.0,NorthBend,98045,2300
3.0,2.0,1790,10209,1.0,0.0,0.0,3.0,1290,500,1967,2011,425000.0,Seattle,98112,1790
3.0,2.0,1190,7280,1.0,0.0,0.0,4.0,1190,0,1968,0,235000.0,Issaquah,98029,1190
4.0,2.0,2260,7200,2.0,0.0,0.0,4.0,2260,0,1984,0,289659.0,Seattle,98118,2260
4.0,1.0,1940,5753,1.5,0.0,0.0,3.0,1940,0,1947,2012,323833.3333,Sammamish,98074,1940
2.0,2.0,2050,11900,1.0,0.0,0.0,4.0,2050,0,1950,1983,532500.0,Auburn,98092,2050
3.0,1.0,1200,8514,1.0,0.0,0.0,3.0,1200,0,1959,1989,165050.0,SeaTac,98188,1200
4.0,2.0,1940,6206,2.0,0.0,0.0,3.0,1940,0,1990,2009,278500.0,Kent,98030,1940
3.0,2.0,1460,10311,1.0,0.0,0.0,4.0,1460,0,1975,0,455500.0,Seattle,98106,1460
4.0,2.0,1800,3245,1.5,0.0,0.0,4.0,1800,0,1929,0,875000.0,Shoreline,98177,1800
3.0,2.0,2320,6775,1.0,0.0,0.0,3.0,2320,0,2008,0,728050.0,Issaquah,98027,2320
4.0,2.0,2800,9538,2.0,0.0,0.0,3.0,2800,0,1993,0,350000.0,DesMoines,98198,2800
4.0,2.0,1450,8450,1.0,0.0,0.0,3.0,1450,0,1960,2012,362500.0,Bellevue,98004,1450
5.0,2.0,2510,8050,1.0,0.0,0.0,4.0,1490,1020,1977,0,475000.0,Shoreline,98177,2510
5.0,4.0,2720,7598,2.0,0.0,0.0,3.0,1860,860,1993,0,690000.0,Seattle,98103,2720
3.0,2.0,1700,3150,2.0,0.0,0.0,3.0,1700,0,2005,0,534500.0,Renton,98059,1700
3.0,2.0,1820,5756,1.5,0.0,0.0,3.0,1640,180,1946,0,683500.0,Redmond,98052,1820
3.0,2.0,1870,7942,2.0,0.0,0.0,3.0,1870,0,1990,2009,299950.0,Issaquah,98029,1870
4.0,2.0,3070,8086,2.0,0.0,0.0,3.0,3070,0,2005,0,804100.0,Sammamish,98074,3070
4.0,1.0,1440,13300,1.0,0.0,0.0,3.0,1440,0,1948,1994,142500.0,Renton,98059,1440
4.0,2.0,1540,1870,2.0,0.0,0.0,3.0,1540,0,2014,0,484998.0,Seattle,98103,1540
2.0,2.0,1460,7926,1.0,0.0,0.0,4.0,1460,0,1987,0,237950.0,MapleValley,98038,1460
3.0,3.0,1530,1565,2.0,0.0,0.0,3.0,1280,250,2005,0,654000.0,Seattle,98105,1530
3.0,3.0,2760,8476,1.0,0.0,0.0,4.0,1690,1070,1967,0,821000.0,Seattle,98168,2760
3.0,2.0,1760,12874,1.0,0.0,0.0,4.0,1230,530,1967,0,497333.3333,Redmond,98052,1760
2.0,1.0,860,2599,1.0,0.0,0.0,4.0,860,0,1901,0,405000.0,Kent,98031,860
2.0,2.0,1950,2719,1.0,0.0,0.0,5.0,1010,940,1919,1934,725000.0,Seattle,98126,1950
3.0,2.0,1670,8364,1.0,0.0,0.0,4.0,1300,370,1990,0,270000.0,Seattle,98116,1670
3.0,2.0,1630,7950,1.0,0.0,0.0,3.0,1320,310,1985,0,279000.0,Issaquah,98029,1630
4.0,2.0,1510,4235,1.0,0.0,0.0,3.0,1510,0,1955,2005,254000.0,Seattle,98115,1510
3.0,2.0,1070,8030,1.0,0.0,0.0,3.0,1070,0,1966,2014,542000.0,Seattle,98125,1070
2.0,2.0,800,5192,1.0,0.0,0.0,5.0,800,0,1951,0,335950.0,Issaquah,98029,800
3.0,2.0,2650,9380,1.0,0.0,0.0,5.0,1680,970,1975,0,590000.0,Kenmore,98028,2650
3.0,2.0,2430,5000,2.0,0.0,0.0,4.0,1760,670,1945,0,626000.0,Issaquah,98027,2430
3.0,2.0,1650,6684,2.0,0.0,0.0,3.0,1650,0,1991,0,268000.0,LakeForestPark,98155,1650
4.0,1.0,1530,8890,1.0,0.0,0.0,3.0,980,550,1925,2002,352000.0,Seattle,98144,1530
3.0,2.0,1640,2808,1.0,0.0,3.0,4.0,820,820,1924,0,570000.0,Kent,98030,1640
4.0,2.0,2060,11385,1.0,0.0,0.0,4.0,1200,860,1962,0,264500.0,Seattle,98115,2060
3.0,1.0,1500,4000,1.0,0.0,0.0,3.0,900,600,1925,2002,395000.0,Seattle,98119,1500
3.0,2.0,1750,1879,3.0,0.0,0.0,3.0,1750,0,2001,0,525000.0,Tukwila,98178,1750
4.0,2.0,2807,9430,2.0,0.0,0.0,3.0,2807,0,1996,0,630000.0,MapleValley,98038,2807
2.0,2.0,1580,3680,1.0,0.0,2.0,3.0,1280,300,1941,1994,530000.0,Tukwila,98188,1580
3.0,2.0,1500,10018,1.0,0.0,0.0,4.0,1500,0,1957,2001,284000.0,Bellevue,98006,1500
4.0,4.0,4080,10666,2.0,0.0,0.0,3.0,4080,0,2005,0,920000.0,Kent,98042,4080
4.0,2.0,1720,6417,1.0,0.0,0.0,3.0,1720,0,1953,0,360000.0,Shoreline,98155,1720
3.0,2.0,2590,15229,2.0,0.0,3.0,3.0,2590,0,1984,0,538250.0,Bellevue,98006,2590
4.0,2.0,1820,8118,1.0,0.0,0.0,4.0,1080,740,1980,0,264000.0,Kenmore,98028,1820
3.0,2.0,1260,9346,1.0,0.0,0.0,4.0,1260,0,1963,0,200500.0,Seattle,98109,1260
3.0,2.0,2140,9484,1.0,0.0,0.0,3.0,1290,850,1953,0,650000.0,Renton,98058,2140
4.0,2.0,2870,6280,1.5,0.0,0.0,4.0,1980,890,1905,0,994500.0,Bellevue,98006,2870
5.0,3.0,3610,9775,2.0,0.0,0.0,3.0,3610,0,2003,0,540000.0,DesMoines,98198,3610
4.0,4.0,3850,13551,2.0,0.0,2.0,3.0,3000,850,1998,2006,995000.0,Redmond,98053,3850
3.0,2.0,1430,3480,1.0,0.0,0.0,3.0,980,450,1947,2012,450000.0,MercerIsland,98040,1430
1.0,1.0,720,5100,1.0,0.0,0.0,3.0,720,0,1907,1983,335000.0,Redmond,98053,720
4.0,2.0,2700,6515,2.0,0.0,0.0,3.0,2700,0,1998,2006,426500.0,Kenmore,98028,2700
4.0,2.0,2420,10200,2.0,0.0,0.0,4.0,2420,0,1973,0,672500.0,Sammamish,98074,2420
3.0,2.0,1730,8490,1.0,0.0,0.0,3.0,1210,520,1969,2010,460000.0,Seattle,98133,1730
3.0,2.0,1150,9600,1.0,0.0,0.0,3.0,1150,0,1979,2014,309212.0,Kent,98030,1150
3.0,2.0,1610,11200,1.0,0.0,0.0,3.0,1610,0,1955,2005,450000.0,Seattle,98146,1610
3.0,2.0,1980,10115,1.0,0.0,0.0,3.0,1980,0,1959,1989,640000.0,Seattle,98168,1980
5.0,3.0,2670,3800,2.0,0.0,0.0,3.0,2670,0,2014,0,341166.6667,Covington,98042,2670
4.0,1.0,1370,8499,1.0,0.0,0.0,3.0,1370,0,1949,1998,300000.0,Renton,98056,1370
4.0,2.0,1530,17664,1.5,0.0,0.0,3.0,1530,0,1968,1997,302000.0,Vashon,98070,1530
3.0,2.0,3310,5300,2.0,0.0,2.0,3.0,2440,870,2008,0,670000.0,Kirkland,98033,3310
2.0,1.0,1010,9219,1.0,0.0,0.0,4.0,1010,0,1960,2001,560000.0,FederalWay,98003,1010
4.0,2.0,2430,4748,1.5,0.0,0.0,3.0,1630,800,1928,1954,723000.0,Bellevue,98004,2430
2.0,1.0,880,4000,1.0,0.0,0.0,3.0,880,0,1940,1996,427550.0,Seattle,98178,880
3.0,2.0,1490,1212,2.0,0.0,0.0,3.0,1040,450,2011,0,735000.0,Renton,98059,1490
3.0,2.0,1830,7969,1.0,0.0,0.0,3.0,930,900,1950,2008,312500.0,Seattle,98178,1830
3.0,2.0,1510,6710,1.0,0.0,0.0,3.0,1070,440,1972,2002,397500.0,Seattle,98126,1510
4.0,2.0,1420,5000,1.5,0.0,0.0,4.0,1420,0,1945,0,535000.0,Seattle,98109,1420
3.0,2.0,1850,5100,1.0,0.0,0.0,3.0,1020,830,1909,2004,580000.0,Shoreline,98155,1850
5.0,2.0,2150,7171,1.0,0.0,0.0,4.0,1460,690,1970,0,279950.0,Seattle,98103,2150
5.0,3.0,1940,6355,1.0,0.0,0.0,3.0,1200,740,2007,0,300000.0,Seattle,98178,1940
3.0,3.0,2210,4000,2.0,0.0,0.0,3.0,2210,0,2008,0,216000.0,Kirkland,98034,2210
4.0,2.0,2600,4800,1.0,0.0,2.0,3.0,1400,1200,1953,0,780000.0,Bellevue,98004,2600
3.0,2.0,2540,4750,1.5,0.0,0.0,5.0,1840,700,1930,0,845000.0,Sammamish,98074,2540
2.0,1.0,620,2475,1.0,0.0,0.0,5.0,620,0,1911,1984,402000.0,Tukwila,98168,620
6.0,2.0,3550,11780,1.0,0.0,0.0,4.0,2960,590,1948,0,450000.0,Bellevue,98006,3550
4.0,2.0,2350,18600,2.0,0.0,0.0,4.0,2350,0,1977,0,747500.0,NorthBend,98045,2350
2.0,2.0,930,747,2.0,0.0,0.0,3.0,630,300,2007,0,355000.0,Seattle,98146,930
1.0,1.0,730,1942,1.0,0.0,0.0,3.0,730,0,2008,0,321500.0,Sammamish,98074,730
4.0,3.0,2890,6885,1.0,0.0,0.0,3.0,1590,1300,1945,2013,476000.0,Bellevue,98007,2890
3.0,2.0,1740,4200,1.5,0.0,0.0,4.0,1640,100,1920,0,473200.0,Seattle,98103,1740
3.0,2.0,2830,6536,2.0,0.0,0.0,3.0,2830,0,1989,0,605500.0,Seattle,98144,2830
3.0,2.0,1470,4950,1.0,0.0,0.0,3.0,1030,440,1984,0,459500.0,Seattle,98116,1470
2.0,1.0,1120,5650,1.0,0.0,0.0,3.0,1120,0,1944,0,190368.75,Shoreline,98155,1120
2.0,2.0,1440,4225,1.0,0.0,0.0,3.0,1440,0,2005,0,437000.0,FederalWay,98023,1440
3.0,2.0,1970,4166,2.0,0.0,3.0,5.0,1270,700,1929,0,550000.0,Woodinville,98077,1970
4.0,2.0,2340,8548,2.0,0.0,0.0,3.0,2340,0,1993,0,390000.0,Redmond,98053,2340
3.0,2.0,1300,7030,1.0,0.0,0.0,3.0,1300,0,1968,1997,385000.0,Covington,98042,1300
4.0,2.0,2020,8424,1.0,0.0,0.0,4.0,1380,640,1979,0,464900.0,Issaquah,98027,2020
3.0,2.0,1420,1237,3.0,0.0,0.0,3.0,1420,0,2014,0,510000.0,Redmond,98053,1420
3.0,2.0,1980,13964,1.0,0.0,0.0,5.0,1980,0,1959,0,760000.0,Kirkland,98034,1980
2.0,1.0,1260,4377,1.0,0.0,0.0,4.0,1260,0,1947,1988,405000.0,Redmond,98053,1260
5.0,3.0,3330,19126,2.0,0.0,0.0,4.0,2610,720,1977,0,950833.3333,FallCity,98024,3330
5.0,2.0,2500,7200,1.0,0.0,0.0,4.0,1490,1010,1977,0,661500.0,Seattle,98105,2500
4.0,2.0,2050,5787,2.0,0.0,0.0,3.0,2050,0,2002,0,256000.0,Woodinville,98077,2050
4.0,2.0,2570,4865,2.0,0.0,0.0,3.0,2570,0,2005,0,320000.0,Kent,98032,2570
3.0,2.0,1720,4080,1.0,0.0,0.0,4.0,960,760,1924,0,615000.0,Auburn,98002,1720
4.0,2.0,1950,9800,1.0,0.0,0.0,3.0,1330,620,1968,1997,560000.0,Seattle,98117,1950
4.0,2.0,1800,8100,2.0,0.0,0.0,3.0,1800,0,1998,2006,250000.0,Renton,98059,1800
4.0,2.0,1760,9602,2.0,0.0,0.0,3.0,1760,0,1987,2000,353500.0,Pacific,98047,1760
3.0,1.0,1100,8536,1.0,0.0,0.0,4.0,1100,0,1957,2001,277000.0,Seattle,98133,1100
3.0,2.0,1430,7347,1.0,0.0,0.0,3.0,820,610,1980,0,198000.0,Redmond,98053,1430
4.0,2.0,2550,5055,2.0,0.0,0.0,4.0,2550,0,1910,0,952500.0,Burien,98146,2550
3.0,2.0,1230,1238,2.0,0.0,0.0,3.0,1080,150,2009,0,435000.0,Auburn,98092,1230
4.0,2.0,1820,5015,1.0,0.0,0.0,4.0,1190,630,1926,1993,300000.0,Seattle,98116,1820
4.0,2.0,1960,9898,2.0,0.0,0.0,3.0,1960,0,2001,0,259585.5714,Seattle,98115,1960
4.0,2.0,3360,15091,2.0,0.0,0.0,3.0,3360,0,1997,0,740000.0,Seattle,98103,3360
2.0,1.0,670,10920,1.0,0.0,0.0,3.0,670,0,1942,1999,240000.0,Auburn,98002,670
4.0,3.0,1910,16532,1.0,0.0,0.0,4.0,1420,490,1940,2001,650000.0,Auburn,98001,1910
2.0,1.0,1080,2674,1.0,0.0,0.0,4.0,720,360,1919,1985,315000.0,LakeForestPark,98155,1080
3.0,4.0,1240,1666,2.0,0.0,0.0,3.0,1000,240,2008,0,435500.0,Seattle,98103,1240
2.0,2.0,1910,3376,2.0,0.0,0.0,3.0,1910,0,1980,0,230000.0,Issaquah,98027,1910
3.0,1.0,1830,8004,1.0,0.0,0.0,3.0,1200,630,1960,2012,403500.0,Bellevue,98008,1830
4.0,2.0,2340,11784,2.0,0.0,0.0,3.0,2340,0,1997,0,330000.0,MercerIsland,98040,2340
3.0,2.0,2680,9162,1.0,0.0,0.0,3.0,1570,1110,1978,0,599990.0,Renton,98058,2680
3.0,2.0,1670,1596,2.0,0.0,0.0,3.0,1220,450,2002,0,505000.0,Auburn,98092,1670
4.0,2.0,2840,11044,2.0,0.0,0.0,3.0,2840,0,2001,0,585000.0,Auburn,98002,2840
2.0,1.0,780,3910,1.0,0.0,0.0,3.0,780,0,1918,0,380000.0,Seattle,98117,780
3.0,3.0,3620,4000,2.0,0.0,0.0,3.0,2730,890,2005,0,1015000.0,Renton,98058,3620
3.0,1.0,1040,8128,1.0,0.0,0.0,3.0,1040,0,1983,2009,234000.0,Sammamish,98074,1040
7.0,2.0,2580,5750,1.0,0.0,0.0,4.0,1880,700,1901,0,599000.0,Medina,98039,2580
4.0,2.0,1770,9375,1.0,0.0,0.0,4.0,1170,600,1968,0,507000.0,LakeForestPark,98155,1770
4.0,3.0,2800,19168,2.0,0.0,0.0,3.0,2800,0,1992,0,999000.0,Seattle,98178,2800
4.0,3.0,2280,15347,1.0,0.0,0.0,5.0,2280,0,1960,0,500000.0,Duvall,98019,2280
3.0,2.0,2280,6031,2.0,0.0,0.0,3.0,2280,0,2011,0,415000.0,Seattle,98126,2280
4.0,2.0,1770,9011,1.0,0.0,0.0,5.0,1050,720,1983,0,264950.0,Shoreline,98177,1770
4.0,3.0,3530,8589,2.0,0.0,0.0,3.0,3530,0,2007,0,963000.0,Bellevue,98005,3530
4.0,2.0,2068,7242,2.0,0.0,0.0,4.0,2068,0,1976,1992,237227.8571,Snoqualmie,98065,2068
3.0,2.0,2783,11177,2.0,0.0,0.0,3.0,2783,0,1910,1999,840000.0,MercerIsland,98040,2783
3.0,2.0,2050,13303,1.0,0.0,0.0,3.0,2050,0,1993,0,314500.0,Kent,98030,2050
2.0,1.0,870,4600,1.0,0.0,0.0,4.0,870,0,1942,1982,287919.7826,Sammamish,98074,870
3.0,2.0,1400,13775,1.0,0.0,0.0,3.0,1400,0,1963,2008,450000.0,FederalWay,98023,1400
4.0,2.0,1870,7471,2.0,0.0,0.0,3.0,1870,0,1990,2009,375000.0,Seattle,98109,1870
2.0,2.0,840,3340,1.0,0.0,0.0,3.0,700,140,1912,1994,450000.0,Shoreline,98133,840
3.0,2.0,1460,941,3.0,0.0,0.0,3.0,1460,0,2006,0,337000.0,Renton,98056,1460
3.0,2.0,1180,7000,1.0,0.0,0.0,4.0,1180,0,1977,0,187500.0,YarrowPoint,98004,1180
4.0,2.0,3250,5000,2.0,0.0,0.0,3.0,3250,0,2008,0,580000.0,Redmond,98052,3250
3.0,2.0,1600,1936,2.0,0.0,0.0,3.0,1600,0,2007,0,395000.0,Redmond,98053,1600
3.0,2.0,2430,10500,2.0,0.0,1.0,3.0,2430,0,1989,0,1027000.0,Redmond,98052,2430
3.0,1.0,1000,8512,1.0,0.0,0.0,3.0,1000,0,1991,0,171758.3333,Issaquah,98027,1000
2.0,1.0,900,13531,1.0,0.0,0.0,3.0,900,0,1979,2014,174000.0,Burien,98166,900
4.0,2.0,2600,9900,1.0,0.0,0.0,3.0,1600,1000,1965,1993,270000.0,Issaquah,98027,2600
3.0,2.0,2540,4775,2.0,0.0,0.0,3.0,2540,0,2006,0,310000.0,Seattle,98126,2540
4.0,3.0,3440,7661,2.0,0.0,0.0,3.0,3440,0,2006,0,905000.0,Redmond,98052,3440
4.0,2.0,2341,9594,2.0,0.0,0.0,3.0,2341,0,1997,0,640000.0,FederalWay,98023,2341
3.0,2.0,1400,8840,1.0,0.0,0.0,4.0,1400,0,1952,0,357250.0,Seattle,98109,1400
3.0,2.0,2110,7665,1.0,0.0,0.0,4.0,1360,750,1973,0,225279.4286,Issaquah,98027,2110
5.0,2.0,2450,6994,2.0,0.0,0.0,3.0,2450,0,2002,0,345000.0,MercerIsland,98040,2450
4.0,3.0,2590,6160,2.0,0.0,0.0,3.0,2590,0,2014,0,519995.0,Seattle,98103,2590
3.0,2.0,1340,4320,1.0,0.0,0.0,3.0,920,420,1912,1993,186000.0,Seattle,98109,1340
4.0,2.0,1980,7403,2.0,0.0,0.0,3.0,1980,0,1988,2000,342246.4286,Seattle,98168,1980
3.0,2.0,2650,2387,2.0,0.0,0.0,3.0,1830,820,1920,1979,850000.0,FederalWay,98001,2650
3.0,1.0,1150,6000,1.5,0.0,0.0,3.0,1150,0,1927,2011,307000.0,Renton,98055,1150
3.0,2.0,2120,7201,2.0,0.0,0.0,3.0,2120,0,2003,0,507000.0,Seattle,98133,2120
4.0,2.0,2220,4652,2.0,0.0,0.0,3.0,2220,0,2001,0,405000.0,Shoreline,98155,2220
4.0,3.0,2000,5827,2.0,0.0,0.0,3.0,2000,0,1997,0,236000.0,Kirkland,98034,2000
3.0,2.0,1230,9600,1.0,0.0,0.0,4.0,1230,0,1984,0,239950.0,Kirkland,98034,1230
4.0,2.0,2800,5900,1.0,0.0,0.0,3.0,1660,1140,1963,2008,744312.5,Auburn,98092,2800
2.0,1.0,1130,2640,1.0,0.0,0.0,4.0,1130,0,1927,0,631500.0,Sammamish,98075,1130
3.0,3.0,3910,19023,2.0,0.0,0.0,3.0,3910,0,1985,0,280000.0,Kent,98031,3910
3.0,2.0,1460,1613,2.0,0.0,0.0,3.0,1180,280,2007,0,544000.0,Kent,98030,1460
4.0,2.0,1540,5120,1.0,0.0,0.0,5.0,770,770,1943,0,395000.0,Seattle,98122,1540
3.0,2.0,3080,12476,2.0,0.0,0.0,3.0,3080,0,1990,2009,315368.7,Auburn,98001,3080
3.0,2.0,3720,11610,2.0,0.0,0.0,3.0,3720,0,1982,0,571986.1111,Seattle,98108,3720
3.0,2.0,1510,6360,1.0,0.0,0.0,4.0,1510,0,1954,1979,308166.6667,Redmond,98053,1510
4.0,2.0,2580,6000,1.0,0.0,0.0,5.0,1300,1280,1950,0,596165.4286,Bothell,98011,2580
3.0,2.0,1990,9594,1.0,0.0,0.0,3.0,1190,800,1977,2004,507500.0,Seattle,98107,1990
6.0,2.0,2890,8122,1.0,0.0,0.0,3.0,1630,1260,1977,2004,502000.0,Seattle,98144,2890
4.0,2.0,2890,7798,2.0,0.0,0.0,3.0,2890,0,2005,0,795000.0,Shoreline,98133,2890
3.0,3.0,2660,4000,2.0,0.0,0.0,3.0,2170,490,2003,0,915000.0,Renton,98058,2660
3.0,1.0,990,4440,1.0,0.0,0.0,3.0,990,0,1943,2002,226550.0,Bellevue,98007,990
3.0,1.0,1390,6000,1.0,0.0,0.0,3.0,1390,0,1954,2005,230000.0,Auburn,98001,1390
3.0,2.0,1620,9310,1.0,0.0,0.0,4.0,1620,0,1967,0,219950.0,Kent,98031,1620
4.0,2.0,2440,11005,2.0,0.0,0.0,3.0,2440,0,1994,0,548000.0,Snoqualmie,98065,2440
4.0,2.0,2010,6300,1.0,0.0,2.0,5.0,1610,400,1937,0,972000.0,Seattle,98103,2010
3.0,2.0,2470,8800,2.0,0.0,0.0,3.0,2470,0,1961,2004,850000.0,Vashon,98070,2470
2.0,1.0,1050,2542,1.0,0.0,0.0,3.0,880,170,1904,0,650000.0,Seattle,98117,1050
4.0,2.0,2500,4046,1.5,0.0,0.0,4.0,1520,980,1940,2001,669500.0,Shoreline,98177,2500
3.0,2.0,1670,6900,1.0,0.0,0.0,3.0,1170,500,1978,0,239950.0,Shoreline,98133,1670
4.0,2.0,2370,6000,1.0,0.0,2.0,3.0,1440,930,1959,1989,899000.0,Renton,98058,2370
3.0,2.0,2220,11646,1.0,0.0,0.0,3.0,1270,950,1950,2005,320000.0,Bellevue,98007,2220
3.0,2.0,1780,8085,1.0,0.0,0.0,3.0,1210,570,1976,0,477000.0,Bellevue,98004,1780
4.0,2.0,2190,11500,1.0,0.0,0.0,4.0,1430,760,1972,0,699900.0,Bellevue,98006,2190
4.0,3.0,3130,5700,1.5,0.0,0.0,3.0,1750,1380,1953,0,671000.0,Auburn,98092,3130
3.0,1.0,1040,6860,2.0,0.0,0.0,3.0,1040,0,1942,1999,148612.5,Bellevue,98006,1040
4.0,2.0,1850,5444,2.0,0.0,0.0,5.0,1850,0,1981,0,475000.0,Auburn,98092,1850
6.0,2.0,2740,6360,1.0,0.0,3.0,3.0,1370,1370,1953,0,675000.0,Kirkland,98033,2740
3.0,2.0,1520,7199,2.0,0.0,0.0,4.0,1520,0,1992,0,275250.0,Bellevue,98005,1520
2.0,1.0,970,5750,1.0,0.0,0.0,4.0,970,0,1932,1958,345000.0,Kent,98031,970
4.0,2.0,1920,8562,2.0,0.0,2.0,4.0,1920,0,1994,0,308950.0,Woodinville,98077,1920
3.0,2.0,1430,2003,2.0,0.0,0.0,3.0,980,450,1996,0,457500.0,Seattle,98103,1430
3.0,2.0,2260,10153,2.0,0.0,0.0,3.0,2260,0,1987,2000,600000.0,Auburn,98092,2260
6.0,2.0,1900,8240,1.0,0.0,0.0,2.0,1200,700,1964,0,305000.0,Kirkland,98033,1900
3.0,2.0,1430,8000,1.0,0.0,0.0,4.0,1430,0,1956,0,518000.0,Burien,98168,1430
3.0,2.0,1450,7375,1.0,0.0,0.0,3.0,1010,440,1968,1997,402000.0,Kirkland,98034,1450
2.0,1.0,870,5750,1.0,0.0,0.0,4.0,870,0,1947,1988,406500.0,Seattle,98126,870
4.0,2.0,2490,12929,2.0,0.0,0.0,3.0,2490,0,1983,2009,616000.0,DesMoines,98198,2490
3.0,1.0,1600,7324,1.0,0.0,0.0,4.0,1600,0,1958,1972,340000.0,DesMoines,98198,1600
3.0,2.0,1900,8002,1.0,0.0,0.0,3.0,1900,0,1991,0,252500.0,Bellevue,98004,1900
3.0,1.0,1620,9450,1.5,0.0,0.0,3.0,1620,0,1928,1954,265000.0,Woodinville,98072,1620
3.0,1.0,990,9798,1.0,0.0,0.0,3.0,990,0,1968,1997,278900.0,Seattle,98199,990
3.0,2.0,1900,3255,2.0,0.0,0.0,3.0,1900,0,1988,2000,550000.0,Auburn,98002,1900
4.0,3.0,1750,5080,1.5,0.0,0.0,3.0,1750,0,1903,2005,750000.0,Kent,98042,1750
4.0,2.0,2160,9593,1.0,0.0,0.0,3.0,2160,0,1969,2010,580000.0,NorthBend,98045,2160
3.0,1.0,1320,5000,1.5,0.0,0.0,3.0,1320,0,1912,1994,201500.0,Burien,98166,1320
3.0,2.0,1950,8712,1.0,0.0,0.0,3.0,1950,0,1960,2012,235000.0,Newcastle,98056,1950
3.0,2.0,1660,15050,1.0,0.0,0.0,3.0,1260,400,1983,2009,453000.0,Seattle,98112,1660
3.0,2.0,2160,3000,1.5,0.0,0.0,3.0,1260,900,1909,2011,378750.0,Redmond,98053,2160
3.0,4.0,2670,6517,2.5,0.0,4.0,4.0,2020,650,1977,0,732000.0,Seattle,98146,2670
3.0,1.0,850,6906,1.0,0.0,0.0,3.0,850,0,1948,1994,325000.0,SeaTac,98168,850
4.0,2.0,2690,4736,2.0,0.0,0.0,3.0,2690,0,2001,0,608000.0,Seattle,98107,2690
3.0,1.0,2150,7007,1.0,0.0,0.0,3.0,2150,0,1954,2005,300000.0,Seattle,98119,2150
4.0,2.0,2090,5289,2.0,0.0,0.0,3.0,2090,0,1989,0,349950.0,Auburn,98001,2090
4.0,2.0,3210,14910,2.0,0.0,0.0,3.0,3210,0,1995,0,690408.6207,Seattle,98105,3210
1.0,1.0,850,8050,1.0,0.0,0.0,2.0,850,0,1906,0,165000.0,Seattle,98108,850
4.0,3.0,2420,4000,1.5,0.0,0.0,5.0,1870,550,1911,1984,790000.0,Renton,98058,2420
3.0,1.0,1050,8498,1.0,0.0,0.0,4.0,1050,0,1959,0,249000.0,Seattle,98106,1050
3.0,2.0,1180,1262,3.0,0.0,0.0,3.0,1180,0,2010,0,472000.0,Bellevue,98006,1180
3.0,1.0,960,7314,1.0,0.0,0.0,5.0,960,0,1960,0,205000.0,Seattle,98115,960
4.0,2.0,2290,11173,2.0,0.0,0.0,4.0,2290,0,1988,0,436500.0,Shoreline,98155,2290
4.0,2.0,1660,4800,1.5,0.0,0.0,3.0,1660,0,1922,2008,550607.1429,Seattle,98118,1660
3.0,1.0,1640,12855,1.5,0.0,0.0,5.0,1500,140,1920,0,1014250.0,DesMoines,98198,1640
3.0,1.0,980,7200,1.0,0.0,0.0,4.0,980,0,1950,1983,430000.0,MercerIsland,98040,980
4.0,3.0,3010,15992,2.0,0.0,0.0,3.0,3010,0,1996,0,775000.0,NorthBend,98045,3010
3.0,2.0,1860,15559,2.0,0.0,0.0,4.0,1860,0,1963,0,380000.0,Kent,98042,1860
4.0,3.0,3060,3898,2.0,0.0,0.0,3.0,2300,760,2014,0,782900.0,Kenmore,98028,3060
3.0,3.0,2410,7479,2.0,0.0,2.0,3.0,2410,0,1942,1988,537000.0,Seattle,98126,2410
5.0,3.0,2190,4900,2.0,0.0,0.0,5.0,1490,700,1940,0,588000.0,Renton,98058,2190
3.0,2.0,1870,5449,2.0,0.0,0.0,3.0,1870,0,2003,0,425000.0,Seattle,98102,1870
4.0,2.0,1440,13296,1.0,0.0,0.0,4.0,1440,0,1967,0,1038000.0,Seattle,98105,1440
3.0,3.0,2030,11070,2.0,0.0,0.0,4.0,2030,0,1980,0,685000.0,MercerIsland,98040,2030
3.0,2.0,1040,9000,1.0,0.0,0.0,4.0,1040,0,1967,0,382500.0,MapleValley,98038,1040
5.0,4.0,3130,4797,2.0,0.0,0.0,3.0,2570,560,2014,0,866059.0,Renton,98059,3130
3.0,2.0,1940,9775,1.0,0.0,2.0,3.0,1440,500,1975,0,545000.0,Sammamish,98075,1940
3.0,2.0,2040,6000,1.0,0.0,0.0,3.0,1340,700,1957,2000,335000.0,Bellevue,98006,2040
3.0,2.0,1990,6350,2.0,0.0,0.0,3.0,1990,0,1967,2011,180000.0,Seattle,98126,1990
4.0,2.0,2120,7420,1.0,0.0,0.0,4.0,1060,1060,1956,0,453000.0,MapleValley,98038,2120
4.0,2.0,1940,10200,1.0,0.0,0.0,4.0,1140,800,1977,0,315000.0,Renton,98059,1940
2.0,1.0,1010,7200,1.0,0.0,0.0,3.0,1010,0,1975,0,285000.0,MapleValley,98038,1010
3.0,2.0,1760,4000,2.0,0.0,0.0,3.0,1760,0,1922,2008,690000.0,Bothell,98011,1760
3.0,2.0,1520,7123,1.0,0.0,0.0,4.0,1520,0,1959,0,292600.0,Seattle,98116,1520
3.0,2.0,2870,8170,2.0,0.0,0.0,3.0,2250,620,1995,0,850000.0,Seattle,98117,2870
4.0,2.0,2400,6000,2.0,0.0,0.0,3.0,2400,0,1913,1945,375000.0,Seattle,98146,2400
5.0,4.0,5340,10655,2.5,0.0,3.0,4.0,3740,1600,1912,1989,195000.0,Seattle,98103,5340
3.0,2.0,2320,10900,2.0,0.0,0.0,3.0,2320,0,1935,1974,737500.0,Seattle,98108,2320
3.0,2.0,1470,7200,2.0,0.0,0.0,4.0,1470,0,1907,0,590300.0,Kent,98031,1470
4.0,2.0,1954,4805,2.0,0.0,0.0,3.0,1954,0,2005,0,268971.875,Seattle,98112,1954
4.0,3.0,3270,12880,2.0,0.0,0.0,3.0,3270,0,2014,0,723243.75,FederalWay,98003,3270
3.0,2.0,1820,12686,1.0,0.0,0.0,4.0,1820,0,1952,0,875000.0,Seattle,98115,1820
4.0,2.0,2070,7350,2.0,0.0,0.0,4.0,2070,0,1977,0,280927.0,Bellevue,98006,2070
4.0,2.0,2660,10800,1.0,0.0,0.0,3.0,2660,0,1955,2014,772650.0,Kenmore,98028,2660
4.0,2.0,2560,4020,2.0,0.0,0.0,3.0,2560,0,2006,0,410000.0,Seattle,98133,2560
3.0,2.0,1540,1326,3.0,0.0,0.0,3.0,1390,150,1995,0,499000.0,Covington,98042,1540
2.0,1.0,900,9260,1.0,0.0,0.0,3.0,900,0,1946,0,496000.0,MercerIsland,98040,900
3.0,2.0,1450,19206,2.0,0.0,0.0,3.0,1450,0,1989,0,410000.0,Auburn,98092,1450
2.0,1.0,1020,8100,1.0,0.0,0.0,3.0,1020,0,1940,1996,195000.0,Seattle,98199,1020
3.0,2.0,2030,6970,2.0,0.0,0.0,4.0,2030,0,1991,0,525000.0,Seattle,98136,2030
4.0,2.0,2960,5054,2.0,0.0,0.0,3.0,2960,0,2006,0,385000.0,Kent,98042,2960
4.0,2.0,2150,3143,2.0,0.0,0.0,3.0,2150,0,2010,0,435000.0,Seattle,98126,2150
3.0,2.0,1410,7466,1.0,0.0,0.0,3.0,1410,0,1983,2009,229950.0,Seattle,98107,1410
5.0,3.0,2920,11880,1.0,0.0,0.0,5.0,1660,1260,1968,0,850000.0,Kent,98042,2920
3.0,3.0,3450,16200,2.0,0.0,0.0,3.0,3450,0,1983,2009,688000.0,Seattle,98109,3450
3.0,2.0,1350,1186,2.0,0.0,0.0,3.0,1120,230,2007,0,468500.0,Sammamish,98075,1350
4.0,3.0,2330,3497,2.0,0.0,0.0,3.0,1920,410,2003,0,490000.0,Seattle,98107,2330
5.0,3.0,2280,10319,1.0,0.0,0.0,3.0,1300,980,1959,1989,420000.0,Newcastle,98056,2280
3.0,2.0,2280,2289,2.0,0.0,0.0,3.0,1880,400,2006,0,500324.0,MapleValley,98038,2280
5.0,3.0,3850,16249,2.0,0.0,2.0,3.0,3030,820,2002,0,507000.0,Seattle,98146,3850
4.0,2.0,1910,10300,1.0,0.0,0.0,3.0,1910,0,1921,1968,458400.0,Woodinville,98072,1910
3.0,2.0,1310,12750,1.0,0.0,0.0,3.0,1310,0,1993,0,337000.0,Kent,98042,1310
3.0,1.0,1050,7577,1.0,0.0,0.0,3.0,1050,0,1983,2009,194000.0,Seattle,98115,1050
5.0,2.0,2330,14322,1.0,0.0,0.0,4.0,1180,1150,1968,0,350000.0,Renton,98059,2330
3.0,2.0,1180,13927,1.0,0.0,0.0,5.0,1180,0,1962,0,299000.0,Issaquah,98029,1180
4.0,3.0,2500,4950,2.0,0.0,0.0,3.0,2500,0,2010,0,680000.0,Seattle,98146,2500
4.0,3.0,3370,12447,2.0,0.0,0.0,3.0,3370,0,1991,0,557125.0,Issaquah,98029,3370
3.0,2.0,1640,8400,1.0,0.0,0.0,3.0,1180,460,1968,1997,245700.0,Issaquah,98029,1640
3.0,2.0,1470,10052,1.0,0.0,0.0,4.0,1470,0,1956,0,480000.0,Auburn,98092,1470
4.0,2.0,2960,6031,2.0,0.0,0.0,3.0,2960,0,2005,0,449000.0,Seattle,98117,2960
4.0,2.0,3560,5265,3.0,0.0,0.0,3.0,3560,0,2014,0,882566.0,Seattle,98177,3560
2.0,1.0,860,6050,1.0,0.0,0.0,3.0,860,0,1952,2008,370000.0,Redmond,98052,860
2.0,2.0,1610,6300,1.0,0.0,0.0,3.0,1010,600,1941,1994,346500.0,Seattle,98103,1610
3.0,2.0,1500,1375,2.0,0.0,0.0,3.0,1200,300,2014,0,649950.0,Issaquah,98029,1500
3.0,2.0,1300,12731,1.0,0.0,0.0,3.0,1300,0,1981,2013,430000.0,Issaquah,98029,1300
4.0,2.0,1740,7500,1.0,0.0,0.0,4.0,1220,520,1976,1992,518000.0,Seattle,98116,1740
4.0,2.0,1810,8750,1.0,0.0,0.0,2.0,1110,700,1967,0,304000.0,Renton,98058,1810
4.0,2.0,2790,17476,1.0,0.0,2.0,3.0,1450,1340,1956,2001,568000.0,Bellevue,98004,2790
3.0,2.0,1700,3333,1.5,0.0,0.0,3.0,1100,600,1924,2011,575000.0,Seattle,98146,1700
6.0,3.0,2520,9324,1.0,0.0,0.0,4.0,1320,1200,1962,0,410000.0,Redmond,98052,2520
3.0,2.0,1160,6134,1.0,0.0,0.0,3.0,1160,0,1998,2006,250000.0,Redmond,98052,1160
4.0,2.0,1700,9000,1.0,0.0,0.0,5.0,1700,0,1972,0,410000.0,Vashon,98070,1700
3.0,2.0,1900,8100,1.0,0.0,0.0,4.0,950,950,1940,2001,520500.0,FederalWay,98023,1900
3.0,3.0,1689,1388,3.0,0.0,0.0,3.0,1689,0,2008,0,384400.0,Seattle,98106,1689
3.0,3.0,1100,750,2.0,0.0,0.0,3.0,780,320,2008,0,286000.0,Burien,98166,1100
4.0,2.0,2770,10274,2.0,0.0,0.0,3.0,2770,0,1989,0,602761.0,BlackDiamond,98010,2770
3.0,2.0,1280,7524,1.5,0.0,0.0,4.0,1280,0,1988,0,242000.0,Seattle,98107,1280
5.0,2.0,2025,7760,2.0,0.0,0.0,3.0,2025,0,2007,0,260000.0,FederalWay,98003,2025
5.0,3.0,3040,10257,2.0,0.0,0.0,3.0,3040,0,1993,0,667781.25,Kirkland,98034,3040
4.0,4.0,3290,5414,2.0,0.0,1.0,3.0,2360,930,2006,0,899950.0,DesMoines,98198,3290
3.0,2.0,1460,6377,1.0,0.0,0.0,3.0,1460,0,1995,0,285000.0,Seattle,98122,1460
3.0,4.0,2490,3582,2.0,0.0,0.0,3.0,1720,770,2005,0,550000.0,ClydeHill,98004,2490
3.0,2.0,1790,3078,2.0,0.0,0.0,3.0,1790,0,2010,0,530000.0,Kent,98032,1790
4.0,2.0,2610,5140,2.0,0.0,0.0,3.0,2610,0,2006,0,674600.0,Renton,98056,2610
4.0,2.0,2190,9880,1.0,0.0,0.0,4.0,1410,780,1979,0,630000.0,Renton,98058,2190
5.0,2.0,2570,9962,2.0,0.0,0.0,3.0,2570,0,2006,0,492500.0,Redmond,98052,2570
2.0,1.0,950,5316,1.0,0.0,2.0,3.0,950,0,1948,1994,320000.0,Enumclaw,98022,950
2.0,1.0,720,11400,1.0,0.0,0.0,5.0,720,0,1951,0,275500.0,Enumclaw,98022,720
3.0,3.0,3050,18892,1.0,1.0,4.0,4.0,1650,1400,1962,0,950000.0,Seattle,98102,3050
3.0,2.0,2400,5000,1.5,0.0,0.0,4.0,1440,960,1926,1993,575000.0,Redmond,98053,2400
4.0,2.0,2050,10920,1.0,0.0,3.0,3.0,1450,600,1974,0,790000.0,Seattle,98107,2050
4.0,2.0,1980,15086,2.0,0.0,0.0,3.0,1980,0,1981,2013,530000.0,Seattle,98126,1980
3.0,2.0,1730,3600,2.0,0.0,0.0,3.0,1730,0,2014,0,328423.0,Redmond,98052,1730
3.0,1.0,1270,7566,1.0,0.0,0.0,4.0,1270,0,1958,1972,276900.0,Seattle,98122,1270
2.0,2.0,1330,6000,1.0,0.0,0.0,4.0,960,370,1914,1945,565000.0,Renton,98056,1330
3.0,1.0,1370,6780,2.0,0.0,0.0,3.0,1370,0,1930,1997,335500.0,Kirkland,98033,1370
2.0,1.0,950,4500,1.0,0.0,2.0,3.0,850,100,1926,2003,500000.0,Seattle,98199,950
3.0,2.0,1490,4800,2.0,0.0,0.0,5.0,1490,0,1948,1985,437500.0,Seattle,98115,1490
3.0,2.0,3060,9950,1.5,0.0,2.0,4.0,1810,1250,1930,0,970000.0,Seattle,98125,3060
4.0,2.0,1750,4779,2.0,0.0,0.0,3.0,1750,0,2009,0,415500.0,Kenmore,98028,1750
2.0,2.0,1570,4665,1.0,0.0,0.0,3.0,1570,0,2006,0,592350.0,Burien,98166,1570
4.0,2.0,2590,7910,2.0,0.0,0.0,3.0,2590,0,2001,0,799000.0,Bellevue,98005,2590
3.0,2.0,1270,1406,2.0,0.0,0.0,3.0,1060,210,2014,0,594000.0,Seattle,98115,1270
3.0,2.0,1820,7326,2.0,0.0,0.0,3.0,1820,0,1983,2009,489950.0,Redmond,98052,1820
4.0,2.0,2460,11250,1.0,0.0,0.0,4.0,2460,0,1959,0,276000.0,Seattle,98112,2460
4.0,2.0,1950,5950,1.0,0.0,0.0,3.0,1330,620,1947,2012,895000.0,Snoqualmie,98065,1950
3.0,3.0,1670,4440,1.0,0.0,0.0,3.0,1670,0,2014,0,246950.0,Woodinville,98072,1670
4.0,2.0,2320,3825,1.5,0.0,0.0,5.0,1820,500,1926,0,941000.0,Seattle,98125,2320
3.0,1.0,1150,7314,1.0,0.0,0.0,3.0,1150,0,1960,2012,300000.0,Seattle,98116,1150
4.0,2.0,2090,5195,2.0,0.0,0.0,3.0,2090,0,2007,0,300000.0,Seattle,98107,2090
1.0,1.0,960,2640,1.0,0.0,0.0,3.0,760,200,1908,1988,332000.0,Shoreline,98155,960
3.0,2.0,1520,4288,1.0,0.0,0.0,3.0,1020,500,1949,1998,380000.0,LakeForestPark,98155,1520
4.0,4.0,3200,3250,2.0,0.0,0.0,3.0,2670,530,2007,0,795000.0,Kenmore,98028,3200
5.0,2.0,2670,16777,1.5,0.0,0.0,4.0,1620,1050,1920,0,585000.0,Seattle,98133,2670
3.0,3.0,2310,3075,2.0,0.0,0.0,3.0,1730,580,2005,0,589500.0,Seattle,98105,2310
4.0,2.0,2400,7693,2.0,0.0,0.0,3.0,2400,0,2003,0,450000.0,Burien,98146,2400
4.0,2.0,1680,3179,2.0,0.0,0.0,3.0,1680,0,2002,0,255000.0,Seattle,98103,1680
3.0,1.0,1210,4731,1.5,0.0,0.0,3.0,1210,0,1901,0,285000.0,Renton,98056,1210
3.0,2.0,2320,10960,1.0,0.0,0.0,3.0,1510,810,1956,2001,657500.0,Burien,98166,2320
4.0,1.0,1200,7200,1.5,0.0,0.0,3.0,1200,0,1944,0,135333.3333,Redmond,98052,1200
5.0,3.0,3370,7947,2.0,0.0,0.0,3.0,3370,0,2001,0,375000.0,Seattle,98115,3370
3.0,2.0,1470,2500,2.0,0.0,0.0,3.0,1080,390,1984,0,490000.0,Seattle,98117,1470
4.0,2.0,3150,4203,2.0,0.0,0.0,3.0,3150,0,2002,0,815000.0,Kirkland,98033,3150
4.0,2.0,2430,5499,2.0,0.0,0.0,3.0,2430,0,2002,0,310000.0,FederalWay,98023,2430
2.0,1.0,770,7906,1.0,0.0,0.0,4.0,770,0,1948,0,260000.0,Sammamish,98075,770
5.0,2.0,1870,11411,1.0,0.0,0.0,4.0,1170,700,1961,2001,554000.0,Sammamish,98075,1870
5.0,6.0,5190,12637,2.0,0.0,2.0,3.0,5190,0,2001,0,925000.0,Renton,98058,5190
3.0,2.0,1110,7231,1.0,0.0,0.0,4.0,1110,0,1991,0,223000.0,Seattle,98178,1110
3.0,2.0,1720,9600,1.0,0.0,0.0,4.0,1220,500,1967,0,550000.0,Seattle,98126,1720
3.0,2.0,1700,14133,1.0,0.0,1.0,4.0,1700,0,1954,1979,979000.0,Seattle,98108,1700
4.0,1.0,1170,8147,1.5,0.0,0.0,3.0,1170,0,1959,1989,350000.0,DesMoines,98198,1170
3.0,2.0,1580,6620,1.0,0.0,0.0,3.0,1580,0,1988,2000,279900.0,Kent,98031,1580
4.0,4.0,4000,15253,2.0,0.0,0.0,3.0,4000,0,2007,0,762000.0,Seattle,98199,4000
3.0,2.0,2310,7200,2.0,0.0,0.0,3.0,2310,0,1990,2009,327500.0,FederalWay,98001,2310
5.0,2.0,3390,9760,1.0,0.0,0.0,5.0,1750,1640,1978,0,288500.0,Seattle,98118,3390
4.0,2.0,2470,5080,1.5,0.0,0.0,3.0,1970,500,1948,1988,339000.0,Sammamish,98075,2470
4.0,4.0,3810,9792,2.0,0.0,0.0,3.0,3810,0,1938,2013,825000.0,Bellevue,98007,3810
3.0,2.0,1940,7500,1.5,0.0,0.0,4.0,1940,0,1918,1985,295000.0,Auburn,98002,1940
2.0,1.0,1090,5000,1.0,0.0,0.0,4.0,730,360,1942,1982,287919.7826,Seattle,98119,1090
4.0,3.0,3580,9316,2.5,0.0,0.0,3.0,2370,1210,1991,0,711600.0,Redmond,98052,3580
3.0,2.0,1320,2500,1.0,0.0,0.0,3.0,870,450,1918,0,530000.0,Redmond,98053,1320
4.0,4.0,3530,14406,2.0,0.0,1.0,3.0,2570,960,1987,2000,874150.0,Seattle,98103,3530
3.0,2.0,2380,14500,1.0,0.0,0.0,4.0,1850,530,1961,2001,370000.0,DesMoines,98198,2380
5.0,2.0,2270,6300,2.0,0.0,0.0,3.0,2270,0,1995,0,285000.0,Seattle,98118,2270
2.0,2.0,1640,4080,1.5,0.0,0.0,5.0,1540,100,1916,0,710000.0,Seattle,98117,1640
3.0,2.0,1590,9912,2.0,0.0,0.0,3.0,1590,0,2000,0,385000.0,Auburn,98092,1590
3.0,2.0,2070,4132,2.0,0.0,0.0,3.0,2070,0,1999,0,535000.0,Bellevue,98004,2070
3.0,2.0,1810,4592,2.0,0.0,0.0,3.0,1810,0,1992,0,513000.0,NorthBend,98045,1810
1.0,1.0,800,16306,1.0,0.0,0.0,2.0,680,120,1931,0,250000.0,Pacific,98047,800
4.0,2.0,2500,8866,2.0,0.0,0.0,4.0,2500,0,1987,0,808000.0,Seattle,98106,2500
4.0,2.0,2060,10358,1.0,0.0,0.0,4.0,1320,740,1962,0,558000.0,Bellevue,98006,2060
4.0,2.0,1770,5750,2.0,0.0,0.0,3.0,1770,0,1947,2012,440000.0,Bellevue,98006,1770
4.0,2.0,2040,7260,2.0,0.0,0.0,4.0,2040,0,1963,0,475000.0,Renton,98058,2040
3.0,2.0,2450,2691,2.0,0.0,0.0,3.0,1750,700,1915,0,937000.0,MercerIsland,98040,2450
3.0,2.0,3350,4007,2.0,0.0,0.0,3.0,2550,800,2005,0,635000.0,Redmond,98052,3350
3.0,3.0,1830,1804,3.0,0.0,0.0,3.0,1830,0,2014,0,599950.0,Renton,98059,1830
4.0,2.0,3030,3841,3.0,0.0,0.0,3.0,3030,0,2005,0,880000.0,FederalWay,98023,3030
3.0,2.0,2432,9391,2.0,0.0,2.0,3.0,2432,0,2005,0,427000.0,Seattle,98116,2432
3.0,2.0,2680,8625,1.0,0.0,0.0,5.0,1590,1090,1974,0,575000.0,Renton,98058,2680
3.0,2.0,2280,5750,1.0,0.0,1.0,4.0,1150,1130,1985,0,475000.0,Covington,98042,2280
3.0,3.0,2470,7410,2.0,0.0,0.0,5.0,1860,610,1977,0,245000.0,Issaquah,98027,2470
3.0,3.0,1910,7280,1.0,0.0,0.0,3.0,1160,750,1979,2014,441000.0,Seattle,98178,1910
3.0,2.0,1980,8755,1.0,0.0,0.0,4.0,1300,680,1963,0,309000.0,Seattle,98126,1980
4.0,3.0,3520,4895,1.0,0.0,0.0,3.0,1980,1540,1954,2005,800000.0,Seattle,98144,3520
3.0,2.0,2440,4800,2.0,0.0,0.0,3.0,2440,0,2014,0,625000.0,Sammamish,98075,2440
3.0,2.0,2400,5300,1.5,0.0,0.0,4.0,1250,1150,1939,1989,672500.0,NormandyPark,98166,2400
3.0,2.0,1880,7400,1.0,0.0,0.0,3.0,1480,400,1968,1997,405000.0,Kent,98042,1880
3.0,2.0,1780,10409,1.0,0.0,0.0,3.0,1280,500,1981,2013,342000.0,Redmond,98052,1780
4.0,3.0,3030,9273,2.0,0.0,0.0,5.0,3030,0,1988,0,660000.0,Bellevue,98008,3030
3.0,2.0,1920,7738,1.0,0.0,0.0,3.0,1520,400,1965,1993,250000.0,Issaquah,98029,1920
3.0,2.0,1810,5080,1.0,0.0,0.0,3.0,1030,780,1958,2004,430000.0,Auburn,98092,1810
4.0,3.0,2200,9778,1.0,0.0,0.0,4.0,1100,1100,1962,0,505000.0,Bellevue,98004,2200
4.0,4.0,3530,8400,2.0,0.0,0.0,5.0,2630,900,1958,0,1095000.0,Sammamish,98074,3530
3.0,2.0,2060,9552,1.0,0.0,0.0,4.0,1610,450,1975,0,885000.0,Seattle,98107,2060
2.0,1.0,1320,9967,1.0,0.0,0.0,3.0,940,380,1919,2001,255000.0,Seattle,98116,1320
2.0,2.0,880,6780,1.0,0.0,0.0,4.0,880,0,1945,0,205425.0,Burien,98166,880
3.0,2.0,1360,10726,1.0,0.0,0.0,4.0,1360,0,1966,0,348500.0,Seattle,98199,1360
4.0,3.0,2450,4187,2.0,0.0,2.0,3.0,2450,0,2010,0,735000.0,Seattle,98106,2450
3.0,2.0,1070,8100,1.0,0.0,0.0,4.0,1070,0,1957,2001,183000.0,Issaquah,98029,1070
4.0,2.0,3190,14565,2.0,0.0,0.0,3.0,3190,0,1990,2009,862000.0,Seattle,98112,3190
2.0,1.0,1190,4440,1.0,0.0,0.0,3.0,1190,0,1981,2013,382500.0,Shoreline,98155,1190
3.0,2.0,1200,9085,1.0,0.0,0.0,4.0,1200,0,1968,0,228950.0,Kirkland,98034,1200
3.0,2.0,1720,3676,2.0,0.0,0.0,3.0,1720,0,1992,0,255950.0,Seattle,98178,1720
4.0,2.0,1540,1860,2.0,0.0,0.0,3.0,1540,0,2014,0,491234.0,Auburn,98092,1540
4.0,2.0,2250,11370,2.0,0.0,0.0,3.0,2250,0,1991,0,600000.0,Kent,98031,2250
3.0,2.0,2180,7741,2.0,0.0,0.0,3.0,2180,0,1986,0,341750.0,Seattle,98107,2180
3.0,2.0,2120,4080,2.0,0.0,0.0,3.0,2120,0,2003,0,535000.0,Seattle,98177,2120
4.0,2.0,2200,9397,2.0,0.0,0.0,3.0,2200,0,1987,2000,237227.8571,Vashon,98070,2200
3.0,2.0,2310,11200,1.0,0.0,0.0,4.0,1630,680,1978,2000,385000.0,Woodinville,98072,2310
6.0,2.0,2380,4080,2.0,0.0,0.0,3.0,2380,0,1917,2009,725000.0,Kent,98031,2380
3.0,1.0,1120,10576,1.0,0.0,0.0,4.0,1120,0,1969,0,320000.0,Seattle,98133,1120
4.0,2.0,2130,7300,1.0,0.0,0.0,4.0,1230,900,1963,0,732600.0,Bellevue,98006,2130
4.0,2.0,2160,5600,1.0,0.0,0.0,5.0,1080,1080,1947,0,756000.0,FederalWay,98003,2160
3.0,2.0,1650,12349,1.0,0.0,0.0,3.0,1650,0,1957,2000,259500.0,FederalWay,98003,1650
4.0,4.0,3770,8501,2.0,0.0,0.0,3.0,3770,0,2008,0,1020000.0,Newcastle,98056,3770
3.0,2.0,1920,9625,2.0,0.0,0.0,3.0,1920,0,1993,0,391500.0,Seattle,98103,1920
4.0,2.0,1250,7400,1.0,0.0,0.0,5.0,1250,0,1959,0,391400.0,Issaquah,98029,1250
3.0,2.0,1010,7683,1.5,0.0,0.0,5.0,1010,0,1953,0,405000.0,Seattle,98119,1010
4.0,3.0,3190,10970,2.0,0.0,0.0,3.0,3190,0,1994,0,687500.0,Sammamish,98075,3190
5.0,1.0,1870,7800,1.0,0.0,0.0,3.0,1580,290,1962,2003,262000.0,Burien,98168,1870
4.0,2.0,2570,7859,2.0,0.0,0.0,3.0,2570,0,1992,0,397500.0,Redmond,98053,2570
3.0,2.0,1720,9000,1.0,0.0,0.0,4.0,1320,400,1969,0,274500.0,Seattle,98146,1720
4.0,2.0,1610,9600,1.0,0.0,0.0,5.0,1610,0,1967,0,415000.0,Kirkland,98033,1610
2.0,2.0,1240,6417,1.0,0.0,0.0,5.0,1240,0,1924,1956,471000.0,Seattle,98133,1240
3.0,1.0,960,8855,1.0,0.0,0.0,4.0,960,0,1958,1972,349810.0,Issaquah,98027,960
4.0,2.0,1780,2788,1.0,0.0,0.0,4.0,890,890,1943,0,442900.0,Seattle,98199,1780
2.0,2.0,1860,10856,1.0,0.0,0.0,3.0,1260,600,1952,2008,265000.0,Kirkland,98034,1860
3.0,2.0,2120,14915,1.0,0.0,0.0,3.0,1720,400,1979,2014,332000.0,Issaquah,98029,2120
3.0,3.0,3176,13391,2.0,0.0,3.0,4.0,2726,450,1985,0,819000.0,Bellevue,98007,3176
3.0,1.0,1480,6978,2.0,0.0,0.0,4.0,1480,0,1949,1985,899000.0,Bellevue,98006,1480
3.0,2.0,3600,8666,2.0,0.0,0.0,4.0,2400,1200,1948,0,461000.0,Milton,98354,3600
2.0,1.0,670,6300,1.0,0.0,0.0,5.0,670,0,1942,0,279000.0,Seattle,98144,670
4.0,2.0,2270,9247,1.0,0.0,0.0,5.0,1500,770,1972,0,619850.0,Seattle,98119,2270
3.0,2.0,1790,7650,1.0,0.0,3.0,3.0,1790,0,1978,0,299950.0,Renton,98059,1790
5.0,2.0,2340,13713,1.0,0.0,0.0,2.0,1670,670,1967,0,235500.0,Seattle,98146,2340
4.0,2.0,1330,5926,1.0,0.0,0.0,4.0,1330,0,1942,1982,235867.0,Renton,98059,1330
5.0,3.0,2620,5477,2.0,0.0,0.0,3.0,2620,0,2009,0,975000.0,Seattle,98117,2620
3.0,2.0,1630,3817,2.0,0.0,0.0,3.0,1630,0,2005,0,497000.0,Bellevue,98005,1630
4.0,2.0,2110,7208,1.0,0.0,0.0,3.0,1170,940,1975,0,324000.0,Burien,98166,2110
1.0,1.0,690,1950,1.0,0.0,0.0,3.0,690,0,1928,1954,167500.0,Bellevue,98006,690
3.0,2.0,1640,10695,1.0,0.0,2.0,3.0,1640,0,1975,0,505000.0,MapleValley,98038,1640
4.0,2.0,2330,8994,2.0,0.0,0.0,3.0,2330,0,1986,0,639500.0,Redmond,98053,2330
3.0,2.0,1760,8584,1.5,0.0,0.0,5.0,1760,0,1937,0,289950.0,Renton,98058,1760
4.0,2.0,2810,11120,2.0,0.0,0.0,3.0,2810,0,1982,0,675000.0,Seattle,98125,2810
2.0,1.0,1020,5130,1.0,0.0,0.0,4.0,1020,0,1948,0,175000.0,Bellevue,98005,1020
2.0,2.0,1580,5750,1.0,0.0,0.0,5.0,790,790,1910,0,558000.0,Seattle,98178,1580
3.0,1.0,1300,8160,1.0,0.0,0.0,4.0,1300,0,1960,2001,237000.0,MapleValley,98038,1300
3.0,2.0,1560,7207,1.0,0.0,0.0,3.0,1250,310,1983,2009,440000.0,Seattle,98119,1560
4.0,4.0,3010,4887,2.0,0.0,3.0,4.0,1940,1070,1951,1996,870000.0,Seattle,98116,3010
4.0,2.0,1360,4840,1.5,0.0,0.0,4.0,1360,0,1928,0,399500.0,NormandyPark,98166,1360
2.0,1.0,950,7954,1.0,0.0,0.0,4.0,950,0,1941,1998,339000.0,Seattle,98103,950
4.0,4.0,3860,18334,2.0,0.0,0.0,3.0,3120,740,1996,0,840000.0,NormandyPark,98166,3860
2.0,2.0,1510,4980,1.0,0.0,0.0,3.0,1510,0,2006,0,419000.0,Seattle,98146,1510
4.0,2.0,2550,8976,1.0,0.0,0.0,5.0,1300,1250,1978,0,328950.0,Issaquah,98029,2550
7.0,2.0,1940,5458,2.0,0.0,0.0,3.0,1940,0,1994,0,280000.0,NormandyPark,98198,1940
2.0,1.0,660,5240,1.0,0.0,0.0,4.0,660,0,1912,1989,100000.0,Woodinville,98077,660
4.0,2.0,1470,8395,1.0,0.0,0.0,4.0,1470,0,1965,0,445000.0,Seattle,98199,1470
5.0,2.0,2700,10875,1.0,0.0,0.0,4.0,1540,1160,1962,0,580000.0,Kent,98030,2700
3.0,2.0,1600,2788,2.0,0.0,0.0,4.0,1600,0,1992,0,245000.0,Seattle,98107,1600
4.0,4.0,4390,13833,2.0,0.0,3.0,3.0,3320,1070,2003,0,1050000.0,Seattle,98125,4390
4.0,2.0,2100,4750,1.0,0.0,0.0,3.0,1340,760,1975,0,759000.0,Seattle,98117,2100
2.0,1.0,660,5000,1.0,0.0,0.0,3.0,660,0,1915,0,175000.0,Seattle,98144,660
3.0,2.0,2590,7720,2.0,0.0,0.0,3.0,2590,0,1988,2000,809000.0,Kenmore,98028,2590
4.0,2.0,2510,4543,2.0,0.0,0.0,3.0,2510,0,2002,0,660000.0,Issaquah,98029,2510
3.0,1.0,1150,8145,1.0,0.0,0.0,4.0,990,160,1932,1958,290000.0,Bellevue,98008,1150
3.0,2.0,1390,18200,1.0,0.0,0.0,4.0,1390,0,1962,0,261350.0,Bellevue,98006,1390
4.0,3.0,1630,7626,1.0,0.0,0.0,5.0,1110,520,1990,0,482500.0,Covington,98042,1630
3.0,2.0,2210,10119,1.0,0.0,0.0,4.0,1450,760,1966,0,210614.2857,Kent,98030,2210
3.0,2.0,1720,6194,2.0,0.0,0.0,3.0,1720,0,1998,2006,255000.0,Seattle,98103,1720
4.0,2.0,1240,3000,1.0,0.0,0.0,3.0,1040,200,1908,1988,375000.0,Seattle,98116,1240
4.0,4.0,2840,4637,3.0,0.0,0.0,3.0,2840,0,2008,0,685000.0,Auburn,98092,2840
2.0,1.0,700,4800,1.0,0.0,0.0,3.0,700,0,1922,2008,260000.0,Bellevue,98008,700
3.0,2.0,1340,7200,1.5,0.0,0.0,4.0,1340,0,1923,0,545000.0,Bellevue,98004,1340
4.0,2.0,1350,942,3.0,0.0,0.0,3.0,1350,0,2008,0,288790.0,Seattle,98105,1350
3.0,2.0,2950,10254,2.0,0.0,0.0,3.0,2950,0,2006,0,554950.0,Newcastle,98056,2950
2.0,2.0,1480,7276,1.0,0.0,0.0,4.0,940,540,1978,2000,269500.0,Bellevue,98006,1480
3.0,2.0,1900,3000,1.5,0.0,0.0,5.0,1070,830,1903,0,311000.0,Newcastle,98056,1900
4.0,2.0,2650,18295,2.0,0.0,0.0,3.0,2650,0,1986,0,725000.0,Woodinville,98072,2650
3.0,1.0,1000,9150,1.0,0.0,0.0,3.0,1000,0,1969,2010,265000.0,Bellevue,98008,1000
2.0,1.0,1230,3800,1.0,0.0,0.0,3.0,1230,0,1928,1954,435000.0,Sammamish,98074,1230
4.0,3.0,3710,7984,2.0,0.0,0.0,3.0,3710,0,1999,0,692500.0,Renton,98059,3710
3.0,1.0,1830,8209,1.0,0.0,0.0,3.0,1830,0,1942,1999,238750.0,Kirkland,98034,1830
2.0,1.0,770,8149,1.0,0.0,0.0,3.0,770,0,1948,1994,229629.5,Seattle,98136,770
3.0,2.0,1660,3729,1.0,0.0,0.0,5.0,970,690,1922,1956,638000.0,Shoreline,98177,1660
3.0,2.0,1490,7770,1.0,0.0,0.0,4.0,1490,0,1990,0,83300.0,Sammamish,98074,1490
4.0,2.0,2700,6998,2.0,0.0,0.0,3.0,2700,0,2001,0,383962.0,Bellevue,98008,2700
4.0,2.0,1570,9415,2.0,0.0,0.0,4.0,1570,0,1984,0,235000.0,Seattle,98168,1570
2.0,1.0,790,6600,1.0,0.0,0.0,3.0,790,0,1949,1998,436000.0,Redmond,98052,790
3.0,2.0,1940,9887,1.0,0.0,0.0,4.0,1140,800,1969,0,232500.0,SeaTac,98188,1940
3.0,2.0,1090,8160,1.0,0.0,0.0,3.0,1090,0,1967,2014,214750.0,Redmond,98052,1090
4.0,2.0,2230,5970,2.0,0.0,0.0,4.0,2230,0,2002,0,337000.0,ClydeHill,98004,2230
5.0,2.0,3600,17300,1.0,0.0,0.0,4.0,2410,1190,1968,0,403500.0,Redmond,98052,3600
4.0,3.0,2310,4020,3.0,0.0,0.0,5.0,2310,0,1979,0,890000.0,Bellevue,98006,2310
4.0,2.0,1860,6687,1.0,0.0,0.0,4.0,1220,640,1983,0,268971.875,BlackDiamond,98010,1860
5.0,3.0,3160,10000,2.0,0.0,0.0,4.0,3160,0,1980,0,574950.0,NorthBend,98045,3160
3.0,2.0,3030,9053,2.0,0.0,0.0,3.0,3030,0,2009,0,509900.0,Duvall,98019,3030
3.0,2.0,2380,6832,2.0,0.0,0.0,3.0,2380,0,2002,0,574000.0,Tukwila,98178,2380
2.0,1.0,690,5280,1.0,0.0,0.0,4.0,690,0,1942,1982,139000.0,Sammamish,98075,690
3.0,4.0,1360,1419,2.0,0.0,0.0,3.0,1040,320,2007,0,515000.0,Seattle,98109,1360
3.0,2.0,1640,9972,1.0,0.0,0.0,4.0,1640,0,1977,0,540833.3333,Kirkland,98033,1640
3.0,2.0,2230,5348,2.0,0.0,0.0,3.0,2230,0,2000,0,490000.0,Burien,98166,2230
3.0,1.0,1350,8700,1.5,0.0,0.0,3.0,1350,0,1942,1999,160000.0,Bellevue,98006,1350
3.0,3.0,2020,10744,1.0,0.0,0.0,5.0,1270,750,1954,0,519000.0,Seattle,98133,2020
4.0,2.0,2400,7700,1.5,0.0,0.0,4.0,1500,900,1927,0,389000.0,Redmond,98053,2400
4.0,2.0,2010,19000,2.0,0.0,0.0,4.0,2010,0,1975,0,322200.0,Bellevue,98007,2010
4.0,3.0,3010,7215,2.0,0.0,0.0,3.0,3010,0,2014,0,723243.75,Duvall,98019,3010
4.0,2.0,2030,11585,1.0,0.0,0.0,4.0,1590,440,1967,0,545000.0,Seattle,98115,2030
3.0,2.0,1700,7532,1.0,0.0,0.0,3.0,1700,0,1987,2000,255000.0,Snoqualmie,98065,1700
2.0,1.0,910,9612,1.0,0.0,0.0,4.0,910,0,1981,0,176400.0,Renton,98058,910
3.0,2.0,2080,12134,1.0,0.0,0.0,4.0,1530,550,1973,0,605000.0,Renton,98059,2080
3.0,2.0,2050,16313,1.0,0.0,0.0,2.0,2050,0,1973,0,623000.0,Snoqualmie,98065,2050
4.0,3.0,2610,4160,3.0,0.0,0.0,5.0,1910,700,1910,0,650000.0,Carnation,98014,2610
4.0,2.0,2100,9984,1.0,0.0,0.0,4.0,1290,810,1973,0,418800.0,Redmond,98052,2100
4.0,1.0,1660,4704,1.5,0.0,0.0,3.0,1260,400,1930,1997,548800.0,Kirkland,98034,1660
3.0,2.0,1060,1536,2.0,0.0,0.0,3.0,1060,0,2000,0,415000.0,Burien,98146,1060
3.0,2.0,1680,11312,1.0,0.0,0.0,3.0,1080,600,1959,1989,330000.0,MapleValley,98038,1680
4.0,2.0,2090,10800,1.0,0.0,0.0,4.0,2090,0,1951,1999,659000.0,Auburn,98092,2090
5.0,3.0,3760,9792,2.0,0.0,0.0,3.0,2550,1210,1984,0,851000.0,Seattle,98112,3760
3.0,2.0,1860,6000,2.0,0.0,2.0,4.0,1860,0,1959,0,725000.0,Seattle,98119,1860
3.0,2.0,1670,7700,1.0,0.0,0.0,3.0,1170,500,1972,2002,424000.0,Woodinville,98077,1670
3.0,2.0,1700,9100,1.0,0.0,0.0,3.0,1160,540,1998,2006,475000.0,Kent,98030,1700
3.0,1.0,1250,6180,1.5,0.0,0.0,3.0,1250,0,1955,2005,233000.0,Seattle,98118,1250
2.0,1.0,1040,3600,1.0,0.0,0.0,4.0,1040,0,1919,1980,600000.0,Seattle,98108,1040
3.0,2.0,1450,1053,2.0,0.0,0.0,3.0,940,510,2008,0,460000.0,Bellevue,98008,1450
3.0,2.0,1360,5980,1.5,0.0,0.0,3.0,1360,0,1945,2008,703000.0,Renton,98058,1360
4.0,2.0,2600,11325,1.0,0.0,0.0,4.0,1610,990,1969,0,304900.0,FederalWay,98023,2600
4.0,3.0,2890,6825,1.0,0.0,0.0,3.0,1560,1330,1973,2013,585000.0,Seattle,98107,2890
3.0,2.0,1700,17355,1.0,0.0,0.0,3.0,1200,500,1978,0,314500.0,Seattle,98115,1700
3.0,2.0,1200,5029,1.0,0.0,0.0,3.0,880,320,1937,1999,420000.0,Woodinville,98072,1200
3.0,2.0,1670,7881,1.0,0.0,0.0,4.0,1190,480,1977,0,252000.0,Burien,98166,1670
3.0,3.0,2090,9620,1.0,0.0,0.0,3.0,1340,750,1987,2000,300000.0,Vashon,98070,2090
3.0,2.0,1510,4800,1.0,0.0,2.0,3.0,860,650,1925,2011,465000.0,Seattle,98126,1510
4.0,4.0,2650,3060,2.0,0.0,0.0,3.0,2060,590,2001,0,1008000.0,Burien,98168,2650
3.0,2.0,1250,7700,1.0,0.0,0.0,5.0,1250,0,1968,0,410000.0,Seattle,98107,1250
4.0,2.0,2620,7553,2.0,0.0,0.0,3.0,2620,0,1996,0,605000.0,Seattle,98105,2620
5.0,3.0,2870,4461,1.0,0.0,0.0,3.0,1650,1220,1976,0,646000.0,Auburn,98002,2870
4.0,4.0,3390,3979,2.0,0.0,0.0,3.0,2610,780,2014,0,1054690.0,Seattle,98119,3390
5.0,3.0,3595,5639,2.0,0.0,0.0,3.0,3595,0,2014,0,861990.0,Seattle,98122,3595
2.0,1.0,1260,3960,1.0,0.0,0.0,3.0,690,570,1925,2002,412000.0,Woodinville,98072,1260
3.0,2.0,1460,7573,2.0,0.0,0.0,3.0,1460,0,1983,2009,534333.3333,FederalWay,98023,1460
3.0,2.0,1270,3600,1.0,0.0,0.0,3.0,1270,0,1963,2008,349500.0,Bellevue,98006,1270
3.0,1.0,1490,7435,1.0,0.0,0.0,3.0,1120,370,1969,2010,258000.0,Bellevue,98008,1490
3.0,2.0,960,8106,1.0,0.0,0.0,3.0,960,0,1962,2003,375000.0,MapleValley,98038,960
4.0,3.0,2160,5005,1.0,0.0,0.0,3.0,1430,730,1987,2000,550000.0,Seattle,98125,2160
2.0,1.0,1020,1350,2.0,0.0,0.0,3.0,1020,0,2009,0,402101.0,Redmond,98053,1020
4.0,1.0,1630,2566,1.5,0.0,0.0,3.0,1630,0,1921,2000,581000.0,FederalWay,98023,1630
3.0,2.0,1610,15005,1.0,0.0,0.0,4.0,1610,0,1986,0,345000.0,Newcastle,98056,1610
2.0,2.0,1310,12196,1.5,0.0,0.0,3.0,1310,0,1970,2014,455000.0,Seattle,98103,1310
2.0,2.0,1068,1758,2.0,0.0,0.0,3.0,1068,0,1990,2009,243000.0,Kirkland,98034,1068
3.0,2.0,1970,11088,1.0,0.0,0.0,4.0,1180,790,1967,0,280000.0,Kirkland,98034,1970
3.0,2.0,1950,15954,1.0,0.0,0.0,4.0,1950,0,1959,0,290000.0,DesMoines,98198,1950
4.0,2.0,2700,9122,2.0,0.0,0.0,3.0,2700,0,1990,2009,652500.0,Snoqualmie,98065,2700
2.0,2.0,2560,2500,2.0,0.0,0.0,5.0,1690,870,1901,0,780000.0,Renton,98058,2560
2.0,1.0,960,8153,1.0,0.0,0.0,3.0,960,0,1947,2012,300000.0,Auburn,98001,960
5.0,4.0,3840,8279,2.0,0.0,0.0,3.0,3840,0,2001,0,875000.0,Seattle,98133,3840
3.0,2.0,1010,9600,1.0,0.0,0.0,4.0,1010,0,1962,0,160000.0,Seattle,98108,1010
3.0,2.0,2242,4995,2.0,0.0,0.0,3.0,2242,0,2011,0,329900.0,Bellevue,98006,2242
3.0,2.0,1620,1075,3.0,0.0,0.0,3.0,1540,80,2009,0,430277.7778,FederalWay,98003,1620
3.0,2.0,2120,7560,1.0,0.0,0.0,3.0,2120,0,1991,0,237481.25,Woodinville,98072,2120
2.0,1.0,1230,1820,2.0,0.0,0.0,4.0,830,400,1948,0,375000.0,Auburn,98092,1230
4.0,2.0,3300,8365,3.0,0.0,0.0,3.0,3300,0,2014,0,760000.0,Kenmore,98028,3300
4.0,2.0,2160,4333,1.0,0.0,0.0,4.0,1260,900,1942,1982,450000.0,Kirkland,98034,2160
4.0,2.0,1590,7920,2.0,0.0,0.0,4.0,1590,0,1960,2001,373000.0,Duvall,98019,1590
3.0,3.0,2300,4637,2.0,0.0,0.0,3.0,2300,0,2008,0,479500.0,Seattle,98125,2300
4.0,3.0,2140,10316,2.0,0.0,0.0,3.0,2140,0,1993,0,359500.0,Auburn,98092,2140
4.0,2.0,2740,12899,2.0,0.0,0.0,4.0,2740,0,1990,0,673476.8182,Seattle,98125,2740
2.0,2.0,2510,14878,2.0,0.0,0.0,3.0,2510,0,1990,2009,600000.0,Seattle,98126,2510
5.0,4.0,3090,7415,2.0,0.0,0.0,3.0,3090,0,2014,0,540500.0,Seattle,98112,3090
2.0,2.0,1240,2500,2.0,0.0,0.0,3.0,1240,0,1985,0,445000.0,Kenmore,98028,1240
4.0,2.0,2000,6107,2.0,0.0,0.0,3.0,2000,0,2003,0,459950.0,Bellevue,98007,2000
3.0,1.0,950,9400,1.0,0.0,0.0,4.0,950,0,1954,1979,248000.0,Seattle,98136,950
3.0,2.0,1240,949,3.0,0.0,0.0,3.0,1240,0,2008,0,543000.0,Burien,98168,1240
3.0,2.0,1550,4980,1.0,0.0,0.0,3.0,1080,470,1978,0,359000.0,Seattle,98103,1550
4.0,1.0,2550,4000,2.0,0.0,0.0,3.0,2370,180,1905,2010,890000.0,SeaTac,98188,2550
2.0,1.0,1240,6400,1.0,0.0,1.0,4.0,1060,180,1938,0,559000.0,Sammamish,98075,1240
3.0,2.0,1940,11612,1.0,0.0,0.0,4.0,1100,840,1981,0,359950.0,Shoreline,98133,1940
3.0,1.0,1460,10000,1.5,0.0,0.0,3.0,1460,0,2002,0,405000.0,FederalWay,98023,1460
4.0,2.0,2550,4770,2.0,0.0,0.0,3.0,2550,0,2005,0,371000.0,Issaquah,98029,2550
2.0,1.0,1500,4000,1.0,0.0,0.0,3.0,1100,400,1933,0,736000.0,Snoqualmie,98065,1500
3.0,2.0,1490,8102,2.0,0.0,0.0,4.0,1490,0,1990,0,220600.0,Woodinville,98077,1490
5.0,3.0,1970,5400,1.0,0.0,0.0,3.0,1320,650,1986,0,399950.0,Seattle,98199,1970
2.0,2.0,1170,1890,1.5,0.0,1.0,4.0,1170,0,1927,0,613000.0,Seattle,98177,1170
2.0,2.0,1110,1773,2.0,0.0,0.0,3.0,1110,0,2014,0,229800.0,Bellevue,98006,1110
3.0,1.0,1200,9087,1.0,0.0,0.0,5.0,1200,0,1969,0,339900.0,Seattle,98112,1200
4.0,2.0,1890,7867,2.0,0.0,0.0,3.0,1890,0,1996,0,355000.0,Bellevue,98005,1890
3.0,2.0,2320,7609,2.0,0.0,0.0,3.0,2320,0,2003,0,600000.0,Seattle,98199,2320
4.0,3.0,3720,15048,3.0,0.0,0.0,3.0,3720,0,1979,2014,500000.0,NormandyPark,98166,3720
3.0,2.0,2110,4118,2.0,0.0,0.0,3.0,2110,0,1989,0,345950.0,Shoreline,98133,2110
2.0,2.0,1210,1032,2.0,0.0,0.0,3.0,1210,0,2014,0,357562.0,Seattle,98116,1210
4.0,2.0,2100,11942,1.0,0.0,0.0,3.0,1030,1070,1964,2000,368000.0,Covington,98042,2100
3.0,1.0,1640,18144,1.5,0.0,0.0,3.0,1640,0,1942,1999,308000.0,Auburn,98001,1640
3.0,1.0,1410,8053,1.0,0.0,0.0,4.0,1410,0,1951,1999,198995.0,Newcastle,98059,1410
3.0,2.0,2430,15264,2.0,0.0,0.0,3.0,2430,0,1997,0,362300.0,FederalWay,98023,2430
3.0,2.0,2250,14274,1.0,0.0,0.0,4.0,1500,750,1964,0,624800.0,Seattle,98112,2250
3.0,2.0,1560,9361,1.5,0.0,0.0,4.0,1360,200,1936,0,545500.0,Sammamish,98074,1560
4.0,2.0,2230,7200,1.0,0.0,0.0,4.0,1300,930,1963,0,400000.0,Vashon,98070,2230
5.0,2.0,1730,9230,1.0,0.0,0.0,3.0,1010,720,1962,2003,287000.0,DesMoines,98198,1730
2.0,2.0,2930,14057,1.0,0.0,2.0,4.0,1680,1250,1980,0,545000.0,Redmond,98053,2930
3.0,1.0,1240,5000,1.5,0.0,0.0,5.0,1240,0,1909,1988,529950.0,Seattle,98144,1240
3.0,2.0,1520,11085,1.0,0.0,0.0,3.0,1520,0,1983,2009,475580.0,Sammamish,98075,1520
5.0,3.0,2870,5700,1.0,0.0,0.0,3.0,1950,920,1964,2000,765000.0,Seattle,98144,2870
3.0,1.0,1250,4800,1.0,0.0,0.0,4.0,1250,0,1951,1999,326428.5714,Auburn,98001,1250
3.0,2.0,1500,11968,1.0,0.0,0.0,3.0,1500,0,2014,0,224000.0,Renton,98059,1500
2.0,1.0,810,4800,1.0,0.0,0.0,3.0,810,0,1919,2001,308830.7692,Seattle,98109,810
3.0,2.0,1580,8184,1.0,0.0,0.0,3.0,1140,440,1954,2005,260000.0,Seattle,98115,1580
4.0,2.0,2610,7091,2.0,0.0,0.0,3.0,2610,0,1987,2000,325000.0,MercerIsland,98040,2610
2.0,1.0,1060,7700,1.0,0.0,0.0,3.0,820,240,1981,2013,170500.0,Tukwila,98168,1060
2.0,2.0,1270,1372,3.0,0.0,0.0,3.0,1270,0,2000,0,438000.0,NorthBend,98045,1270
3.0,2.0,1400,1022,3.0,0.0,0.0,3.0,1400,0,2007,0,425000.0,Shoreline,98155,1400
3.0,2.0,2238,7209,2.0,0.0,0.0,3.0,2238,0,2011,0,330000.0,Renton,98059,2238
3.0,2.0,1550,4708,1.0,0.0,0.0,4.0,860,690,1949,1985,460000.0,Seattle,98126,1550
3.0,1.0,880,9238,1.5,0.0,0.0,5.0,880,0,1946,0,291500.0,Kirkland,98033,880
4.0,2.0,1660,9760,2.0,0.0,0.0,3.0,1660,0,1994,0,294999.0,MapleValley,98038,1660
3.0,2.0,2070,15002,1.5,0.0,0.0,3.0,2070,0,1955,2013,560000.0,Kirkland,98033,2070
4.0,2.0,1830,9601,2.0,0.0,0.0,3.0,1830,0,2003,0,321000.0,Bellevue,98006,1830
3.0,1.0,880,18205,1.0,0.0,0.0,4.0,880,0,1945,0,218000.0,Seattle,98112,880
3.0,2.0,2330,12141,1.0,0.0,0.0,3.0,1390,940,1983,2009,535000.0,Renton,98059,2330
3.0,3.0,2220,4000,2.0,0.0,0.0,3.0,1700,520,1914,2000,800000.0,Seattle,98144,2220
3.0,2.0,1440,12888,1.0,0.0,2.0,3.0,1090,350,1958,2004,260000.0,Woodinville,98072,1440
3.0,2.0,1410,8100,2.0,0.0,0.0,3.0,1410,0,1985,0,263000.0,NormandyPark,98166,1410
2.0,2.0,1350,1493,2.0,0.0,0.0,3.0,1050,300,2007,0,395000.0,FederalWay,98023,1350
2.0,1.0,790,11234,1.0,0.0,0.0,4.0,790,0,1942,1982,250275.0,Duvall,98019,790
3.0,2.0,1320,6000,1.5,0.0,0.0,4.0,1320,0,1920,0,410000.0,Seattle,98144,1320
3.0,3.0,1380,1120,3.0,0.0,0.0,3.0,1380,0,2008,0,482000.0,Seattle,98118,1380
2.0,1.0,930,6380,1.0,0.0,0.0,4.0,930,0,1940,2001,395000.0,Redmond,98052,930
3.0,2.0,1590,8219,1.5,0.0,0.0,5.0,970,620,1938,0,387884.6154,Kirkland,98033,1590
4.0,2.0,1820,8255,1.5,0.0,0.0,4.0,1320,500,1930,0,399888.0,Seattle,98148,1820
1.0,1.0,700,2500,1.0,0.0,0.0,4.0,700,0,1907,0,295000.0,Bellevue,98006,700
3.0,2.0,1440,11787,1.0,0.0,0.0,3.0,1440,0,1983,2009,495000.0,Snoqualmie,98065,1440
2.0,1.0,740,6180,1.0,0.0,0.0,3.0,740,0,1948,1994,342000.0,Auburn,98002,740
3.0,2.0,1410,7998,1.0,0.0,0.0,4.0,1410,0,1940,2001,220000.0,Seattle,98107,1410
4.0,2.0,1740,8449,1.0,0.0,0.0,4.0,1170,570,1958,1972,455000.0,Seattle,98106,1740
5.0,3.0,3260,11700,1.0,0.0,0.0,3.0,1630,1630,1964,2000,681500.0,Sammamish,98074,3260
3.0,2.0,1640,7222,2.0,0.0,0.0,4.0,1640,0,1908,0,295000.0,Issaquah,98027,1640
3.0,2.0,1940,9000,1.0,0.0,0.0,4.0,970,970,1948,0,576000.0,Seattle,98117,1940
4.0,2.0,1550,5053,1.0,0.0,0.0,4.0,1180,370,1963,0,433000.0,Woodinville,98077,1550
5.0,2.0,1840,10453,1.0,0.0,2.0,3.0,1360,480,1948,1994,395000.0,Auburn,98002,1840
3.0,2.0,2500,7394,2.0,0.0,0.0,3.0,2500,0,1990,2009,565000.0,Kent,98042,2500
4.0,2.0,3340,8930,2.0,0.0,2.0,3.0,3340,0,1999,0,720000.0,Bellevue,98006,3340
4.0,1.0,1120,7104,1.5,0.0,0.0,3.0,1120,0,1946,0,554000.0,Auburn,98002,1120
4.0,2.0,2380,5000,2.0,0.0,0.0,3.0,2380,0,2005,0,360000.0,Seattle,98115,2380
4.0,3.0,4690,14930,2.0,0.0,2.0,3.0,3680,1010,1995,0,600000.0,Seattle,98125,4690
3.0,2.0,2120,6290,1.0,0.0,0.0,4.0,1220,900,1949,1985,440000.0,MapleValley,98038,2120
3.0,2.0,2340,5957,2.0,0.0,0.0,3.0,2340,0,1995,0,426090.0,Kenmore,98028,2340
5.0,2.0,2700,16570,1.0,0.0,0.0,4.0,1750,950,1967,0,744500.0,Auburn,98001,2700
4.0,2.0,2490,9525,2.0,0.0,0.0,5.0,2490,0,1968,0,940000.0,Newcastle,98056,2490
3.0,2.0,1300,19163,1.0,0.0,0.0,3.0,1300,0,1964,2000,425000.0,Kirkland,98033,1300
3.0,2.0,1800,6000,1.0,0.0,0.0,5.0,900,900,1905,0,471001.0,Seattle,98106,1800
4.0,3.0,2130,6325,1.0,0.0,0.0,5.0,1440,690,1948,1985,620000.0,Seattle,98117,2130
3.0,2.0,1430,8960,1.0,0.0,0.0,4.0,1430,0,1953,1983,178650.0,Seattle,98178,1430
4.0,2.0,2610,4595,2.0,0.0,0.0,3.0,2610,0,2008,0,535000.0,Seattle,98122,2610
5.0,2.0,2780,10192,2.0,0.0,0.0,4.0,2780,0,1978,2000,830000.0,Shoreline,98155,2780
3.0,2.0,2220,4060,1.0,0.0,0.0,3.0,1330,890,1993,0,330000.0,Burien,98166,2220
2.0,1.0,1190,6200,1.0,0.0,0.0,3.0,1190,0,1948,1994,295950.0,FederalWay,98003,1190
4.0,3.0,3030,6625,2.0,0.0,0.0,3.0,3030,0,2011,0,525000.0,MapleValley,98038,3030
4.0,3.0,2330,3920,2.0,0.0,0.0,3.0,2330,0,2005,0,680000.0,Seattle,98168,2330
4.0,4.0,3440,6000,2.0,0.0,0.0,4.0,3440,0,2002,0,455000.0,Issaquah,98029,3440
3.0,2.0,2110,11319,2.0,0.0,0.0,4.0,2110,0,1978,2000,479000.0,Snoqualmie,98065,2110
4.0,2.0,2650,5600,2.0,0.0,0.0,3.0,2650,0,2014,0,542525.0,Sammamish,98074,2650
3.0,2.0,1990,12793,2.0,0.0,0.0,3.0,1990,0,1993,0,450000.0,Renton,98056,1990
5.0,2.0,2370,15512,2.0,0.0,0.0,4.0,2370,0,1981,0,913888.0,Burien,98166,2370
4.0,2.0,1890,6962,2.0,0.0,0.0,3.0,1890,0,1997,0,280500.0,Seattle,98116,1890
4.0,2.0,3920,12415,2.0,0.0,0.0,3.0,3920,0,1997,0,770000.0,FederalWay,98003,3920
3.0,2.0,2670,10481,2.0,0.0,0.0,3.0,2670,0,2003,0,645325.0,Seattle,98125,2670
3.0,2.0,1720,8100,2.0,0.0,0.0,3.0,1720,0,1907,1983,667000.0,Seattle,98117,1720
5.0,2.0,2340,4500,2.0,0.0,0.0,3.0,2340,0,2009,0,429000.0,Shoreline,98155,2340
2.0,2.0,1920,3408,1.0,0.0,0.0,4.0,960,960,1912,1989,517000.0,Sammamish,98074,1920
4.0,2.0,2120,9603,2.0,0.0,0.0,3.0,2120,0,1985,0,575000.0,MapleValley,98038,2120
4.0,2.0,2120,4558,2.0,0.0,0.0,3.0,2120,0,2002,0,329950.0,Renton,98058,2120
3.0,1.0,1230,6000,1.0,0.0,0.0,4.0,1230,0,1967,0,229500.0,Seattle,98115,1230
3.0,1.0,1230,8750,1.0,0.0,0.0,3.0,1230,0,1965,1993,205000.0,Renton,98055,1230
2.0,1.0,1050,6600,1.5,0.0,0.0,3.0,1050,0,1964,2000,168333.3333,Bothell,98011,1050
4.0,2.0,3190,8195,2.0,0.0,0.0,3.0,3190,0,2006,0,589950.0,Sammamish,98074,3190
2.0,2.0,1260,1347,3.0,0.0,0.0,3.0,1260,0,2005,0,350000.0,Seattle,98144,1260
4.0,2.0,2000,3672,2.0,0.0,0.0,5.0,1650,350,1926,0,402000.0,Seattle,98178,2000
3.0,1.0,1750,7800,1.0,0.0,0.0,4.0,1150,600,1956,0,251555.5556,Seattle,98144,1750
4.0,2.0,1740,9344,1.0,0.0,0.0,3.0,1180,560,1978,0,204950.0,Redmond,98053,1740
3.0,2.0,1910,3481,2.0,0.0,0.0,3.0,1910,0,2009,0,293000.0,Seattle,98144,1910
2.0,1.0,840,3400,1.0,0.0,2.0,4.0,840,0,1924,0,464600.0,Redmond,98052,840
4.0,2.0,1970,6600,2.0,0.0,0.0,3.0,1970,0,1987,2000,274900.0,Seattle,98109,1970
4.0,2.0,2050,9583,2.0,0.0,2.0,3.0,1770,280,1965,1993,386000.0,Auburn,98002,2050
3.0,2.0,1310,6738,1.0,0.0,0.0,4.0,1310,0,1990,0,249900.0,Medina,98039,1310
3.0,2.0,1660,9673,1.0,0.0,0.0,3.0,1130,530,1976,0,375000.0,NorthBend,98045,1660
4.0,3.0,3090,5859,2.0,0.0,0.0,3.0,3090,0,2010,0,760005.0,Tukwila,98168,3090
2.0,2.0,1930,3521,2.0,0.0,0.0,3.0,1930,0,1989,0,509000.0,Kent,98032,1930
4.0,2.0,2570,9000,1.0,0.0,0.0,4.0,1590,980,1979,0,287500.0,Redmond,98052,2570
3.0,4.0,2080,2250,3.0,0.0,4.0,3.0,2080,0,1997,0,715000.0,Kent,98030,2080
4.0,2.0,1600,6180,1.5,0.0,0.0,3.0,1600,0,1946,0,425000.0,Seattle,98133,1600
3.0,2.0,2040,10086,2.0,0.0,0.0,3.0,2040,0,1987,2000,542500.0,Kent,98031,2040
3.0,2.0,1800,2790,2.0,0.0,0.0,3.0,1800,0,2011,0,364000.0,Kent,98042,1800
3.0,2.0,1580,9187,1.0,0.0,0.0,3.0,1180,400,1993,0,263000.0,Bellevue,98006,1580
2.0,1.0,1290,4650,1.0,0.0,0.0,4.0,1290,0,1906,1990,406062.5,Renton,98058,1290
3.0,2.0,1460,9908,1.0,0.0,0.0,3.0,1460,0,1952,2008,310000.0,Seattle,98177,1460
4.0,2.0,2170,7737,2.0,0.0,0.0,3.0,2170,0,1987,2000,566000.0,Seattle,98117,2170
3.0,2.0,1490,1294,2.0,0.0,0.0,3.0,1220,270,2010,0,309000.0,Seattle,98199,1490
3.0,2.0,1570,8750,1.0,0.0,0.0,3.0,1570,0,1960,2012,240000.0,Shoreline,98155,1570
5.0,2.0,2950,5500,1.5,0.0,0.0,5.0,1720,1230,1918,0,660500.0,Kirkland,98033,2950
4.0,2.0,1840,11367,1.5,0.0,0.0,4.0,1840,0,1950,1983,415000.0,Snoqualmie,98065,1840
3.0,2.0,1920,8223,2.0,0.0,0.0,4.0,1920,0,1989,0,443000.0,Seattle,98144,1920
3.0,2.0,2530,13446,2.0,0.0,0.0,3.0,2530,0,1993,0,435000.0,Seattle,98199,2530
4.0,2.0,2000,10051,2.0,0.0,0.0,3.0,2000,0,1997,0,320000.0,Bellevue,98004,2000
4.0,2.0,2030,3974,2.0,0.0,0.0,3.0,2030,0,1994,0,544000.0,Issaquah,98027,2030
3.0,2.0,1510,7884,1.0,0.0,0.0,3.0,1510,0,1942,2014,332000.0,Seattle,98126,1510
2.0,2.0,1990,4000,1.0,0.0,0.0,5.0,1090,900,1952,1998,454790.0,Enumclaw,98022,1990
2.0,1.0,890,4590,1.0,0.0,0.0,3.0,890,0,1923,1998,423050.9259,Kent,98030,890
4.0,2.0,2380,13550,2.0,0.0,0.0,3.0,2380,0,1999,0,330000.0,Enumclaw,98022,2380
3.0,2.0,1410,6413,1.0,0.0,0.0,4.0,910,500,1947,1988,590000.0,Seattle,98199,1410
4.0,2.0,1580,5340,1.0,0.0,0.0,3.0,1130,450,1947,2012,351250.0,Seattle,98125,1580
3.0,2.0,1400,6300,1.0,0.0,0.0,3.0,1400,0,1998,2006,235000.0,Redmond,98053,1400
3.0,1.0,1090,10710,1.0,0.0,0.0,4.0,1090,0,1962,0,280000.0,Sammamish,98074,1090
3.0,2.0,1960,6380,1.0,0.0,0.0,4.0,980,980,1939,1989,561500.0,SeaTac,98188,1960
3.0,2.0,2242,4500,2.0,0.0,0.0,3.0,2242,0,2014,0,309780.0,Seattle,98122,2242
3.0,2.0,1510,7066,1.0,0.0,2.0,3.0,1230,280,1973,2013,300000.0,Seattle,98168,1510
4.0,2.0,2660,12672,1.0,0.0,0.0,4.0,1740,920,1960,2001,310000.0,Carnation,98014,2660
2.0,1.0,1180,6552,1.0,0.0,0.0,4.0,1180,0,1949,1985,275000.0,Enumclaw,98022,1180
3.0,2.0,1500,5412,1.0,0.0,0.0,5.0,900,600,1920,0,485000.0,Seattle,98102,1500
2.0,1.0,1320,8830,1.0,0.0,0.0,3.0,1020,300,1939,1969,425000.0,Kent,98030,1320
3.0,2.0,1320,8114,1.0,0.0,0.0,3.0,1320,0,1951,1994,650000.0,Carnation,98014,1320
2.0,2.0,1950,10766,1.0,0.0,3.0,4.0,1160,790,1952,0,669000.0,Issaquah,98029,1950
3.0,2.0,2600,4506,2.0,0.0,0.0,3.0,2600,0,2003,0,515000.0,Tukwila,98168,2600
3.0,2.0,1840,11440,1.0,0.0,0.0,4.0,1340,500,1977,0,366000.0,Seattle,98116,1840
4.0,2.0,2080,7200,1.0,0.0,0.0,4.0,1050,1030,1966,0,198000.0,Auburn,98001,2080
3.0,2.0,1550,9720,1.0,0.0,0.0,3.0,1050,500,1976,0,255000.0,Kent,98031,1550
4.0,2.0,2170,8518,1.0,0.0,3.0,3.0,1350,820,1955,2005,415000.0,FederalWay,98003,2170
3.0,2.0,2760,17377,2.0,0.0,0.0,3.0,2760,0,2002,0,545000.0,NorthBend,98045,2760
3.0,2.0,1370,1524,3.0,0.0,0.0,3.0,1370,0,2005,0,433111.1111,FederalWay,98003,1370
3.0,1.0,1210,9622,1.0,0.0,1.0,3.0,1210,0,1955,2009,660000.0,Renton,98058,1210
5.0,1.0,1710,9100,1.5,0.0,0.0,4.0,1320,390,1926,1993,560000.0,Auburn,98002,1710
4.0,2.0,2430,8960,1.0,0.0,0.0,3.0,1430,1000,1960,2012,255000.0,Seattle,98107,2430
4.0,2.0,2640,8625,2.0,0.0,0.0,3.0,2640,0,1987,2000,429900.0,Kirkland,98033,2640
4.0,2.0,1880,6200,1.0,0.0,2.0,5.0,1440,440,1954,0,680000.0,Redmond,98052,1880
2.0,1.0,1110,3200,1.0,0.0,0.0,3.0,1110,0,1925,2002,665000.0,SeaTac,98168,1110
3.0,1.0,1540,3399,1.5,0.0,0.0,3.0,1200,340,1926,2003,530100.0,Kirkland,98034,1540
3.0,1.0,860,5060,1.5,0.0,0.0,3.0,860,0,1927,2011,320000.0,Seattle,98106,860
4.0,2.0,2540,8400,2.0,0.0,0.0,5.0,2540,0,1977,0,269950.0,Auburn,98001,2540
2.0,1.0,1570,8210,1.0,0.0,0.0,4.0,1150,420,1952,0,506000.0,Seattle,98105,1570
4.0,2.0,2090,6023,2.0,0.0,0.0,3.0,2090,0,1990,2009,545000.0,Woodinville,98072,2090
3.0,1.0,1340,13750,1.0,0.0,0.0,4.0,1340,0,1955,2009,479000.0,Vashon,98070,1340
3.0,2.0,2140,11266,2.0,0.0,0.0,3.0,2140,0,1986,0,400000.0,Seattle,98126,2140
3.0,2.0,1850,7777,2.0,0.0,0.0,5.0,1850,0,1989,0,623000.0,Seattle,98103,1850
2.0,2.0,830,1119,2.0,0.0,0.0,3.0,830,0,2005,0,329445.0,Seattle,98136,830
3.0,2.0,1470,8089,1.0,0.0,0.0,3.0,1470,0,1987,2000,280000.0,Seattle,98177,1470
4.0,2.0,2980,16263,2.0,0.0,0.0,3.0,2980,0,1989,0,1012000.0,Redmond,98053,2980
4.0,4.0,2500,3080,2.0,0.0,0.0,3.0,1810,690,2008,0,599950.0,DesMoines,98198,2500
4.0,2.0,3230,12100,1.0,0.0,0.0,3.0,1870,1360,1977,2004,827000.0,Seattle,98199,3230
4.0,2.0,2380,7066,2.0,0.0,0.0,4.0,2380,0,1997,0,268971.875,Issaquah,98027,2380
3.0,2.0,1930,7214,2.0,0.0,0.0,3.0,1930,0,2005,0,530000.0,Kirkland,98034,1930
4.0,3.0,2700,6000,2.0,0.0,0.0,4.0,2100,600,1910,0,749000.0,Burien,98146,2700
3.0,3.0,1370,913,2.0,0.0,0.0,3.0,1100,270,2006,0,390000.0,FederalWay,98023,1370
3.0,4.0,2130,6150,2.0,0.0,2.0,5.0,1530,600,1908,0,819000.0,Kirkland,98034,2130
3.0,1.0,1040,5000,1.0,0.0,0.0,3.0,1040,0,1959,1989,148612.5,Kirkland,98033,1040
4.0,2.0,2120,11479,1.0,0.0,0.0,4.0,1060,1060,1940,2001,489000.0,Renton,98056,2120
5.0,2.0,2980,7781,1.0,0.0,0.0,3.0,1580,1400,1960,2012,600000.0,Seattle,98125,2980
4.0,2.0,1970,10500,1.0,0.0,0.0,3.0,1820,150,1961,2004,410000.0,Redmond,98052,1970
3.0,2.0,2920,9370,1.0,0.0,0.0,4.0,1620,1300,1981,0,650000.0,Seattle,98115,2920
3.0,2.0,950,1110,2.0,0.0,0.0,3.0,950,0,2003,0,475000.0,Bellevue,98007,950
4.0,2.0,2220,9496,1.0,0.0,0.0,4.0,1490,730,1954,1979,921000.0,Sammamish,98075,2220
3.0,3.0,1530,1612,3.0,0.0,0.0,3.0,1530,0,2006,0,607500.0,Seattle,98112,1530
3.0,2.0,2570,10431,2.0,0.0,0.0,3.0,2570,0,1989,0,399950.0,Renton,98059,2570
3.0,2.0,3180,12600,2.0,0.0,0.0,4.0,3180,0,1978,2000,900000.0,FederalWay,98023,3180
3.0,2.0,1770,8235,1.0,0.0,0.0,3.0,1030,740,1960,2012,295000.0,Sammamish,98074,1770
3.0,2.0,2010,7200,2.0,0.0,0.0,3.0,2010,0,1994,0,515000.0,Kirkland,98033,2010
2.0,2.0,1590,1845,2.0,0.0,0.0,3.0,1590,0,1997,0,409900.0,Kent,98042,1590
4.0,2.0,2810,10613,2.0,0.0,0.0,3.0,2810,0,1989,0,810000.0,Seattle,98136,2810
4.0,3.0,3510,9400,2.0,0.0,0.0,3.0,3510,0,2014,0,659950.0,Sammamish,98075,3510
6.0,3.0,3110,5000,1.5,0.0,0.0,5.0,1810,1300,1921,0,725000.0,Seattle,98126,3110
3.0,2.0,1460,3044,2.0,0.0,0.0,3.0,1460,0,2000,0,299880.0,Seattle,98144,1460
3.0,2.0,1660,10150,1.5,0.0,0.0,3.0,1660,0,1957,2000,350000.0,Renton,98056,1660
3.0,1.0,1170,6700,1.0,0.0,0.0,3.0,1170,0,1957,2000,415000.0,Auburn,98092,1170
4.0,2.0,1730,3884,1.0,0.0,0.0,5.0,1060,670,1924,1956,569000.0,MapleValley,98038,1730
1.0,1.0,370,1801,1.0,0.0,0.0,5.0,370,0,1923,0,276000.0,Kirkland,98034,370
4.0,2.0,2550,19017,1.0,0.0,0.0,4.0,1300,1250,1961,2001,460000.0,Seattle,98136,2550
4.0,2.0,2670,11877,2.0,0.0,0.0,3.0,2670,0,1996,0,669950.0,Seattle,98106,2670
4.0,2.0,1995,7102,2.0,0.0,0.0,4.0,1995,0,1981,0,266000.0,Vashon,98070,1995
5.0,2.0,2220,9360,1.0,0.0,0.0,4.0,1110,1110,1968,0,299000.0,Skykomish,98288,2220
5.0,2.0,2310,13430,1.5,0.0,0.0,4.0,2310,0,1966,0,850000.0,Seattle,98146,2310
3.0,1.0,1100,4128,1.0,0.0,0.0,4.0,720,380,1942,1982,339000.0,Enumclaw,98022,1100
3.0,2.0,1610,8613,1.0,0.0,0.0,5.0,1610,0,1962,0,725000.0,Seattle,98109,1610
5.0,3.0,2790,19439,1.0,0.0,3.0,5.0,1500,1290,1973,0,589950.0,Redmond,98052,2790
4.0,2.0,2510,7992,1.0,0.0,0.0,3.0,1610,900,1978,0,319000.0,Seattle,98122,2510
3.0,2.0,3290,6830,2.0,0.0,0.0,3.0,3290,0,2000,0,930000.0,Kirkland,98033,3290
2.0,2.0,2290,9772,1.0,0.0,0.0,3.0,2290,0,2007,0,737000.0,Kenmore,98028,2290
5.0,3.0,1810,3000,2.0,0.0,0.0,3.0,1810,0,1998,2006,362000.0,Redmond,98053,1810
2.0,1.0,1100,4200,1.0,0.0,0.0,3.0,1100,0,1954,2005,343566.0,Redmond,98052,1100
4.0,1.0,1440,7100,1.5,0.0,0.0,3.0,1440,0,1906,2014,500000.0,Ravensdale,98051,1440
4.0,2.0,2990,8913,2.0,0.0,0.0,4.0,2990,0,1991,0,469900.0,Redmond,98053,2990
8.0,3.0,2790,6695,1.0,0.0,0.0,3.0,1470,1320,1977,2004,340000.0,Kent,98032,2790
5.0,1.0,1590,6700,1.5,0.0,0.0,3.0,1090,500,1942,1999,185000.0,DesMoines,98198,1590
2.0,2.0,920,1598,2.0,0.0,0.0,3.0,920,0,1995,0,255000.0,Seattle,98168,920
3.0,2.0,1180,7300,1.0,0.0,0.0,4.0,1180,0,1968,0,209950.0,Redmond,98052,1180
3.0,3.0,2750,18029,1.0,0.0,2.0,5.0,1810,940,1978,0,540000.0,Renton,98056,2750
4.0,3.0,1940,8170,1.0,0.0,0.0,4.0,1940,0,1948,0,265000.0,Vashon,98070,1940
2.0,1.0,900,5100,1.0,0.0,0.0,4.0,900,0,1909,1989,473000.0,Bellevue,98006,900
3.0,2.0,1750,7020,2.0,0.0,0.0,3.0,1750,0,1934,1978,510000.0,Kirkland,98034,1750
3.0,2.0,1570,7000,2.0,0.0,2.0,4.0,1050,520,1971,0,233166.6667,Enumclaw,98022,1570
3.0,2.0,1880,12821,1.0,0.0,0.0,3.0,1880,0,1959,1989,389800.0,Renton,98058,1880
3.0,1.0,1660,11783,1.0,0.0,0.0,4.0,1160,500,1978,2000,367500.0,Seattle,98112,1660
3.0,2.0,2300,3060,1.5,0.0,0.0,3.0,1510,790,1930,2002,738190.8571,Snoqualmie,98065,2300
5.0,2.0,1740,8750,1.0,0.0,0.0,4.0,1740,0,1959,0,199950.0,Seattle,98115,1740
3.0,2.0,1430,6000,1.0,0.0,0.0,5.0,1430,0,1945,0,352450.0,Issaquah,98029,1430
3.0,2.0,1090,9600,1.0,0.0,0.0,4.0,1090,0,1968,0,200000.0,Seattle,98105,1090
4.0,2.0,3030,8507,2.0,0.0,0.0,3.0,3030,0,2003,0,902000.0,Seattle,98117,3030
3.0,2.0,1150,10466,1.0,0.0,0.0,5.0,1150,0,1959,0,464500.0,LakeForestPark,98155,1150
4.0,2.0,2460,4200,2.0,0.0,0.0,3.0,2460,0,1998,2006,568500.0,Seattle,98109,2460
3.0,2.0,1660,6263,2.0,0.0,0.0,3.0,1660,0,2003,0,285000.0,Woodinville,98077,1660
3.0,1.0,1200,7800,1.0,0.0,0.0,4.0,1200,0,1954,1979,275000.0,Renton,98055,1200
4.0,1.0,1310,5200,1.5,0.0,0.0,3.0,1160,150,1945,2010,266066.6667,Renton,98056,1310
4.0,2.0,2701,4500,2.0,0.0,0.0,3.0,2701,0,2014,0,399895.0,Issaquah,98029,2701
2.0,1.0,890,8100,1.0,0.0,0.0,3.0,890,0,1942,1999,150000.0,Issaquah,98027,890
3.0,2.0,1420,1309,3.0,0.0,0.0,3.0,1420,0,2006,0,510000.0,Kent,98042,1420
3.0,1.0,970,9583,1.0,0.0,0.0,4.0,970,0,1967,0,209950.0,Renton,98056,970
3.0,2.0,880,6600,1.0,0.0,0.0,5.0,880,0,1945,0,253000.0,Issaquah,98029,880
3.0,3.0,2420,1923,2.0,0.0,2.0,3.0,1840,580,2006,0,1010000.0,Snoqualmie,98065,2420
3.0,2.0,2140,7200,1.0,0.0,0.0,4.0,1480,660,1966,0,346150.0,Seattle,98103,2140
3.0,3.0,2220,8227,1.5,0.0,0.0,5.0,1770,450,1929,0,569000.0,Kent,98030,2220
2.0,1.0,860,5040,1.0,0.0,0.0,3.0,860,0,1956,2001,370000.0,Seattle,98109,860
2.0,1.0,1010,3000,1.0,0.0,0.0,4.0,1010,0,1925,1968,280000.0,Shoreline,98155,1010
4.0,3.0,2230,9640,1.0,0.0,0.0,3.0,1320,910,1998,2006,435000.0,Sammamish,98075,2230
4.0,3.0,2840,4000,1.5,0.0,0.0,5.0,1960,880,1912,0,870000.0,Seattle,98108,2840
3.0,2.0,1890,13860,1.0,0.0,0.0,5.0,1890,0,1966,0,292285.7143,Vashon,98070,1890
6.0,3.0,2980,5000,1.5,0.0,0.0,3.0,2480,500,1916,1986,775000.0,Bothell,98011,2980
3.0,1.0,1580,3840,2.0,0.0,0.0,3.0,1580,0,1908,1988,729000.0,Seattle,98119,1580
2.0,1.0,1060,7200,1.0,0.0,0.0,4.0,1060,0,1951,1999,299995.0,Seattle,98115,1060
3.0,2.0,1560,5223,1.0,0.0,0.0,4.0,810,750,1940,2001,399950.0,Renton,98058,1560
2.0,1.0,920,7569,1.0,0.0,0.0,4.0,920,0,1950,1983,202000.0,MercerIsland,98040,920
4.0,2.0,2720,10006,2.0,0.0,0.0,3.0,2720,0,1989,0,594950.0,LakeForestPark,98155,2720
3.0,2.0,1630,7700,1.0,0.0,0.0,3.0,1120,510,1978,0,264270.0,Enumclaw,98022,1630
3.0,4.0,1360,1275,2.0,0.0,0.0,3.0,1240,120,2007,0,397000.0,Covington,98042,1360
4.0,2.0,2270,5102,1.0,0.0,0.0,5.0,1340,930,1954,0,735000.0,MercerIsland,98040,2270
4.0,4.0,4150,16197,2.0,0.0,0.0,3.0,4150,0,2006,0,550000.0,Renton,98056,4150
3.0,2.0,1070,8000,1.0,0.0,0.0,3.0,1070,0,1977,2004,415000.0,Kent,98032,1070
3.0,2.0,2375,4094,2.0,0.0,0.0,3.0,2375,0,2002,0,712000.0,Kirkland,98034,2375
3.0,2.0,2670,7500,1.0,0.0,0.0,4.0,1640,1030,1966,0,465000.0,Redmond,98053,2670
4.0,2.0,2000,3988,1.0,0.0,4.0,4.0,1000,1000,1958,1972,810000.0,Burien,98148,2000
6.0,3.0,2660,8400,1.0,0.0,0.0,5.0,1550,1110,1962,0,603500.0,Renton,98059,2660
3.0,2.0,1970,8200,1.0,0.0,0.0,5.0,1420,550,1963,0,540000.0,Seattle,98115,1970
3.0,1.0,1320,7341,1.0,0.0,0.0,3.0,1320,0,1982,0,370000.0,Burien,98166,1320
3.0,2.0,1640,7350,1.0,0.0,0.0,3.0,1140,500,1984,0,221000.0,Seattle,98133,1640
3.0,3.0,1820,1641,3.0,0.0,0.0,3.0,1540,280,2006,0,625000.0,Redmond,98052,1820
4.0,3.0,2620,4743,1.0,0.0,2.0,4.0,1310,1310,1949,1985,815000.0,Kirkland,98033,2620
4.0,2.0,2990,16809,2.0,0.0,0.0,3.0,2990,0,1990,2009,800000.0,Shoreline,98155,2990
5.0,3.0,2830,8925,1.5,0.0,0.0,3.0,2830,0,1967,2011,451000.0,Seattle,98122,2830
4.0,1.0,1200,6000,1.5,0.0,0.0,3.0,1200,0,1923,1998,220000.0,Kent,98031,1200
3.0,2.0,1200,1400,3.0,0.0,0.0,3.0,1200,0,2005,0,320000.0,Issaquah,98027,1200
3.0,2.0,1190,4072,1.5,0.0,0.0,5.0,1190,0,1907,0,245000.0,Woodinville,98077,1190
3.0,1.0,1400,7360,1.0,0.0,0.0,4.0,1400,0,1968,0,148226.0,Duvall,98019,1400
2.0,1.0,810,4080,1.0,0.0,0.0,4.0,810,0,1941,1998,325000.0,BlackDiamond,98010,810
3.0,2.0,1720,3012,2.0,0.0,0.0,3.0,1720,0,2011,0,500000.0,Newcastle,98059,1720
4.0,2.0,2160,7826,1.0,0.0,0.0,4.0,1390,770,1976,1992,440000.0,Seattle,98125,2160
3.0,1.0,1090,3264,1.0,0.0,0.0,4.0,1090,0,1969,0,152000.0,Kent,98042,1090
4.0,2.0,1700,8640,1.0,0.0,0.0,3.0,850,850,1955,2010,282766.6667,Seattle,98115,1700
1.0,1.0,930,7129,1.0,0.0,0.0,3.0,930,0,1948,1994,210000.0,Woodinville,98072,930
3.0,2.0,2140,3821,2.0,0.0,0.0,3.0,2140,0,2005,0,420000.0,Tukwila,98168,2140
2.0,1.0,1010,11919,1.0,0.0,0.0,3.0,1010,0,1947,2012,300000.0,Sammamish,98075,1010
3.0,2.0,2250,7904,1.5,0.0,0.0,3.0,2250,0,1998,2006,328000.0,Seattle,98144,2250
3.0,1.0,1740,10875,1.0,0.0,0.0,4.0,1020,720,1962,0,267000.0,Bellevue,98007,1740
2.0,1.0,840,4239,1.0,0.0,0.0,3.0,840,0,1948,1994,325000.0,Seattle,98103,840
3.0,2.0,3316,11447,2.0,0.0,0.0,3.0,3316,0,1986,0,490600.0,Kent,98031,3316
4.0,2.0,1740,7700,1.0,0.0,0.0,5.0,1740,0,1968,0,600000.0,Woodinville,98072,1740
3.0,2.0,1710,8767,1.0,0.0,0.0,4.0,1710,0,1986,0,630000.0,Seattle,98108,1710
3.0,2.0,2060,5750,1.0,0.0,0.0,3.0,1330,730,1976,0,577000.0,Shoreline,98155,2060
3.0,2.0,1660,6250,1.0,0.0,0.0,3.0,830,830,1980,0,410000.0,Newcastle,98059,1660
5.0,3.0,2130,6222,1.0,0.0,0.0,3.0,1300,830,1991,0,325000.0,Burien,98166,2130
5.0,3.0,2820,6589,1.5,0.0,0.0,3.0,2320,500,1906,2014,408000.0,MercerIsland,98040,2820
2.0,1.0,1020,7920,1.0,0.0,0.0,3.0,1020,0,1939,1969,235000.0,Bellevue,98006,1020
4.0,2.0,2180,10140,1.0,0.0,0.0,4.0,1180,1000,1968,0,540000.0,Seattle,98116,2180
3.0,2.0,1180,4080,1.0,0.0,0.0,4.0,760,420,1928,0,450000.0,NormandyPark,98166,1180
3.0,2.0,2700,1438,2.0,0.0,0.0,3.0,1280,1420,2003,0,670000.0,Auburn,98002,2700
6.0,4.0,3000,8401,1.0,0.0,0.0,3.0,1500,1500,1979,2014,527000.0,Seattle,98122,3000
4.0,3.0,2910,6308,1.0,0.0,0.0,3.0,1640,1270,1985,0,525000.0,Sammamish,98075,2910
4.0,2.0,1710,10440,1.0,0.0,0.0,4.0,1710,0,1955,2009,525000.0,Sammamish,98074,1710
5.0,3.0,2550,7725,1.0,0.0,0.0,5.0,1390,1160,1967,0,480000.0,Newcastle,98056,2550
4.0,3.0,2360,4924,2.0,0.0,0.0,3.0,2360,0,2008,0,525000.0,Bellevue,98005,2360
4.0,2.0,2050,5276,2.0,0.0,0.0,3.0,2050,0,2006,0,385000.0,Seattle,98118,2050
4.0,2.0,2060,7283,1.0,0.0,0.0,3.0,1220,840,1963,2013,410000.0,Kirkland,98033,2060
2.0,1.0,1050,5000,1.0,0.0,0.0,5.0,1050,0,1907,0,515000.0,Kent,98030,1050
3.0,2.0,2110,3600,2.0,0.0,0.0,3.0,2110,0,2005,0,638000.0,Bothell,98011,2110
3.0,2.0,1430,8865,1.0,0.0,0.0,3.0,1430,0,1950,2005,330000.0,MercerIsland,98040,1430
4.0,2.0,1830,6136,2.0,0.0,0.0,3.0,1830,0,1990,2009,249000.0,Covington,98042,1830
3.0,2.0,2880,9750,2.0,0.0,0.0,3.0,2880,0,1989,0,820000.0,Bellevue,98008,2880
2.0,2.0,1680,5756,2.0,0.0,0.0,4.0,1680,0,1910,0,210000.0,Sammamish,98074,1680
2.0,2.0,1390,4482,1.0,0.0,0.0,4.0,1390,0,1980,0,216500.0,Bellevue,98006,1390
4.0,2.0,2800,10786,1.0,0.0,0.0,3.0,1420,1380,1970,2014,605000.0,Sammamish,98075,2800
3.0,2.0,1640,1269,3.0,0.0,0.0,3.0,1640,0,2009,0,579000.0,Seattle,98106,1640
5.0,2.0,2080,16117,1.0,0.0,0.0,5.0,1740,340,1959,0,254000.0,Seattle,98136,2080
4.0,2.0,2286,8269,2.0,0.0,0.0,3.0,2286,0,2002,0,481000.0,Seattle,98103,2286
2.0,2.0,1380,953,3.0,0.0,0.0,3.0,1380,0,2006,0,549000.0,Redmond,98053,1380
4.0,3.0,3220,4392,1.5,0.0,0.0,4.0,2320,900,1931,0,880000.0,Seattle,98103,3220
3.0,2.0,1650,2958,2.0,0.0,0.0,3.0,1650,0,1985,0,233500.0,Seattle,98115,1650
3.0,1.0,1170,11100,1.0,0.0,0.0,4.0,1170,0,1968,0,235000.0,Renton,98056,1170
4.0,2.0,1820,6753,2.0,0.0,0.0,3.0,1820,0,1994,0,322500.0,Seattle,98178,1820
2.0,3.0,1350,1252,2.0,0.0,0.0,3.0,1120,230,2006,0,405500.0,Seattle,98117,1350
3.0,3.0,2340,16500,1.0,0.0,0.0,4.0,1500,840,1972,0,237333.3333,Seattle,98125,2340
2.0,2.0,1050,1029,2.0,0.0,0.0,3.0,950,100,2007,0,332888.0,Kent,98031,1050
3.0,2.0,1550,5511,2.0,0.0,0.0,3.0,1550,0,1987,2000,481015.0,Redmond,98052,1550
4.0,2.0,3040,6587,2.0,0.0,0.0,3.0,3040,0,2003,0,650000.0,Kent,98031,3040
3.0,1.0,910,7700,1.0,0.0,0.0,4.0,910,0,1971,0,300000.0,Seattle,98118,910
3.0,1.0,1180,8240,1.0,0.0,0.0,4.0,1180,0,1967,0,205000.0,Kent,98031,1180
3.0,1.0,1320,8450,1.0,0.0,0.0,3.0,880,440,1961,2004,232500.0,Bellevue,98004,1320
2.0,2.0,2150,5760,1.0,0.0,0.0,3.0,2150,0,2010,0,741500.0,Duvall,98019,2150
3.0,1.0,1010,8184,1.0,0.0,0.0,4.0,1010,0,1947,1988,349000.0,Redmond,98052,1010
4.0,2.0,1900,7200,1.0,0.0,0.0,3.0,1370,530,1977,2004,485000.0,Kent,98042,1900
2.0,1.0,700,3000,1.0,0.0,0.0,4.0,700,0,1918,1974,310000.0,Seattle,98126,700
4.0,3.0,3330,9143,2.0,0.0,0.0,4.0,3330,0,1995,0,1095000.0,Seattle,98199,3330
4.0,2.0,2570,9503,2.0,0.0,0.0,3.0,2570,0,1980,0,439000.0,Seattle,98108,2570
3.0,2.0,2090,10733,1.0,0.0,0.0,3.0,1440,650,1958,2004,491950.0,Seattle,98107,2090
2.0,2.0,950,4625,1.0,0.0,0.0,4.0,950,0,1949,1985,430000.0,Kenmore,98028,950
4.0,2.0,2530,5650,1.5,0.0,0.0,4.0,1910,620,1910,0,631500.0,Burien,98166,2530
3.0,3.0,2770,6278,2.0,0.0,0.0,3.0,1980,790,2006,0,461000.0,Kent,98031,2770
4.0,2.0,2530,5048,2.0,0.0,0.0,3.0,2530,0,2014,0,417838.0,Bellevue,98006,2530
4.0,2.0,2510,6853,2.0,0.0,2.0,3.0,2510,0,2006,0,448000.0,Renton,98055,2510
3.0,2.0,1480,7700,1.0,0.0,0.0,3.0,1480,0,1975,0,395000.0,Seattle,98107,1480
2.0,1.0,1620,9205,1.0,0.0,0.0,5.0,850,770,1921,0,350000.0,Seattle,98144,1620
4.0,2.0,2760,6000,2.0,0.0,0.0,5.0,2230,530,1942,0,760000.0,Seattle,98118,2760
3.0,2.0,1270,1413,3.0,0.0,0.0,3.0,1270,0,2007,0,440000.0,Renton,98058,1270
3.0,2.0,1570,15330,1.0,0.0,0.0,3.0,1080,490,1956,2001,289987.5,Seattle,98119,1570
3.0,2.0,1520,9041,1.0,0.0,0.0,4.0,1520,0,1954,1979,810000.0,Enumclaw,98022,1520
4.0,4.0,3370,3634,2.0,0.0,0.0,3.0,2750,620,2007,0,812000.0,Issaquah,98027,3370
3.0,2.0,1340,8505,1.0,0.0,0.0,3.0,1340,0,1931,0,215000.0,Kirkland,98033,1340
2.0,2.0,1590,11276,1.0,0.0,0.0,4.0,1590,0,1972,0,225500.0,Seattle,98103,1590
3.0,1.0,1470,6500,1.0,0.0,0.0,4.0,1470,0,1953,1983,410000.0,Seattle,98126,1470
4.0,2.0,2870,5453,2.0,0.0,1.0,4.0,2220,650,1926,1993,665900.0,Kent,98031,2870
4.0,2.0,2710,6583,2.0,0.0,0.0,3.0,2710,0,2003,0,560000.0,Bellevue,98006,2710
3.0,1.0,1020,8610,1.0,0.0,0.0,5.0,1020,0,1959,0,265000.0,Seattle,98125,1020
3.0,2.0,2150,4333,1.0,0.0,0.0,3.0,1200,950,1956,2001,440825.0,Woodinville,98077,2150
4.0,2.0,1850,6000,1.0,0.0,0.0,4.0,1270,580,1944,0,230000.0,Kirkland,98034,1850
3.0,3.0,1680,1570,3.0,0.0,0.0,3.0,1680,0,2014,0,330000.0,Seattle,98122,1680
4.0,2.0,2470,3811,2.0,0.0,0.0,3.0,2470,0,1999,0,449950.0,NorthBend,98045,2470
3.0,2.0,1590,3411,2.0,0.0,0.0,3.0,1590,0,2000,0,356000.0,Seattle,98118,1590
1.0,2.0,1010,5750,1.0,0.0,0.0,3.0,1010,0,1911,1948,410000.0,Seattle,98117,1010
3.0,2.0,2610,6405,2.0,0.0,0.0,3.0,2610,0,2001,0,605000.0,MapleValley,98038,2610
3.0,2.0,1800,12196,1.0,0.0,0.0,4.0,1800,0,1966,0,305000.0,Seattle,98199,1800
3.0,2.0,2250,5692,2.0,0.0,0.0,3.0,2250,0,2000,0,445838.0,Seattle,98117,2250
2.0,1.0,1080,3500,1.0,0.0,3.0,3.0,1080,0,1924,2011,525000.0,Newcastle,98059,1080
4.0,2.0,2100,8400,1.0,0.0,0.0,4.0,1240,860,1976,1992,468000.0,Seattle,98199,2100
5.0,3.0,2430,8000,1.0,0.0,0.0,4.0,1370,1060,1957,2001,506000.0,Seattle,98144,2430
2.0,2.0,940,1768,2.0,0.0,0.0,3.0,940,0,2009,0,362500.0,MercerIsland,98040,940
5.0,2.0,2800,17788,1.0,0.0,0.0,4.0,1400,1400,1963,0,665000.0,MapleValley,98038,2800
4.0,2.0,2550,10000,1.0,0.0,0.0,3.0,1290,1260,1964,2000,642000.0,NorthBend,98045,2550
4.0,3.0,2100,4480,1.5,0.0,0.0,4.0,1780,320,1928,0,679000.0,Auburn,98092,2100
2.0,1.0,800,7260,1.0,0.0,0.0,3.0,800,0,1953,0,325000.0,Renton,98059,800
4.0,2.0,3360,11548,2.0,0.0,0.0,3.0,3360,0,1988,2000,950000.0,Issaquah,98029,3360
1.0,2.0,1170,1456,2.0,0.0,0.0,3.0,1070,100,2007,0,235000.0,Bellevue,98007,1170
4.0,2.0,2303,3826,2.0,0.0,0.0,3.0,2303,0,2006,0,300000.0,Seattle,98136,2303
3.0,2.0,1620,6000,1.0,0.0,0.0,5.0,1040,580,1947,0,640000.0,Burien,98166,1620
3.0,2.0,2640,6715,2.0,0.0,0.0,3.0,1680,960,1991,0,365000.0,Renton,98058,2640
2.0,1.0,840,11600,1.0,0.0,0.0,3.0,840,0,1952,2008,187000.0,Kent,98042,840
3.0,2.0,1780,16290,2.0,0.0,0.0,4.0,1780,0,1987,0,350000.0,Vashon,98070,1780
3.0,1.0,1010,8800,1.0,0.0,0.0,4.0,1010,0,1954,1979,308000.0,Redmond,98053,1010
3.0,3.0,1630,1677,3.0,0.0,0.0,3.0,1630,0,2007,0,385000.0,Sammamish,98075,1630
3.0,2.0,1460,8710,1.0,0.0,0.0,3.0,1460,0,1955,2005,324950.0,Seattle,98102,1460
3.0,3.0,2820,5348,2.0,0.0,0.0,3.0,2820,0,2008,0,749000.0,Kent,98031,2820
5.0,3.0,3010,12611,2.0,0.0,0.0,3.0,3010,0,1994,0,837700.0,Seattle,98116,3010
3.0,2.0,1670,4800,1.5,0.0,3.0,3.0,1670,0,1903,2005,1020000.0,Seattle,98136,1670
3.0,1.0,1110,12150,1.0,0.0,0.0,4.0,1110,0,1957,2001,416000.0,Issaquah,98029,1110
3.0,2.0,1400,9546,1.0,0.0,0.0,4.0,1400,0,1984,0,217500.0,Seattle,98118,1400
4.0,3.0,2200,10800,1.0,0.0,0.0,3.0,2200,0,1960,2012,300000.0,Seattle,98103,2200
3.0,2.0,2790,13791,1.0,0.0,3.0,3.0,2790,0,2006,0,1131000.0,Kenmore,98028,2790
3.0,1.0,1200,9936,1.0,0.0,0.0,4.0,1200,0,1969,0,108333.3333,Bellevue,98006,1200
3.0,2.0,1820,9670,2.0,0.0,0.0,3.0,1820,0,1984,0,557500.0,Renton,98059,1820
4.0,2.0,2620,4469,2.0,0.0,0.0,3.0,2620,0,2008,0,300000.0,LakeForestPark,98155,2620
3.0,2.0,2500,4080,1.5,0.0,0.0,5.0,1680,820,1922,1956,695000.0,Seattle,98103,2500
4.0,2.0,1720,6975,1.0,0.0,0.0,3.0,1420,300,1975,0,580000.0,Seattle,98199,1720
4.0,2.0,1890,6938,1.5,0.0,0.0,3.0,1890,0,1919,2001,825000.0,Issaquah,98027,1890
3.0,2.0,2760,10160,1.0,0.0,0.0,3.0,2760,0,1969,2010,336000.0,Bellevue,98008,2760
3.0,2.0,1920,9680,1.0,0.0,0.0,4.0,1300,620,1961,2001,260000.0,Kirkland,98034,1920
5.0,2.0,2000,4211,1.5,0.0,2.0,4.0,1280,720,1908,0,690500.0,MapleValley,98038,2000
3.0,2.0,1860,15681,1.0,0.0,0.0,4.0,1860,0,1971,0,275000.0,Sammamish,98074,1860
3.0,2.0,1880,6008,2.0,0.0,0.0,3.0,1880,0,2009,0,284000.0,Auburn,98002,1880
3.0,2.0,1660,1545,2.0,0.0,2.0,3.0,1400,260,2002,0,700000.0,MapleValley,98038,1660
3.0,2.0,1750,12325,1.0,0.0,0.0,4.0,1470,280,1968,0,499000.0,Bellevue,98004,1750
5.0,3.0,4500,9648,2.0,0.0,4.0,4.0,3000,1500,1968,0,860000.0,Auburn,98002,4500
2.0,2.0,1570,3600,1.5,0.0,2.0,4.0,1320,250,1906,1990,782000.0,Seattle,98122,1570
2.0,1.0,1120,2000,1.5,0.0,0.0,3.0,1120,0,1910,2006,524000.0,Seattle,98116,1120
2.0,2.0,1088,1360,2.0,0.0,0.0,3.0,1088,0,1983,2009,250000.0,LakeForestPark,98155,1088
4.0,2.0,1670,3315,2.0,0.0,0.0,3.0,1670,0,2005,0,451000.0,Seattle,98115,1670
3.0,1.0,1410,7200,2.0,0.0,0.0,4.0,1410,0,1901,0,700000.0,LakeForestPark,98155,1410
4.0,3.0,3550,12327,1.5,0.0,0.0,4.0,2180,1370,1990,0,720000.0,Seattle,98126,3550
3.0,2.0,2540,5612,2.0,0.0,0.0,3.0,2540,0,1999,0,425000.0,Enumclaw,98022,2540
4.0,2.0,3490,5000,2.0,0.0,0.0,3.0,3490,0,2003,0,297857.1429,Seattle,98117,3490
5.0,2.0,3530,9385,1.5,0.0,0.0,3.0,3530,0,1925,2002,930000.0,Shoreline,98155,3530
3.0,2.0,1990,5560,1.0,0.0,0.0,4.0,1100,890,1939,1989,763101.0,Kent,98042,1990
4.0,2.0,1890,6302,2.0,0.0,0.0,3.0,1890,0,1997,0,282000.0,Redmond,98053,1890
3.0,2.0,1630,1526,3.0,0.0,0.0,3.0,1630,0,2014,0,609000.0,Woodinville,98072,1630
3.0,2.0,1190,4750,1.0,0.0,0.0,3.0,970,220,1940,1996,500000.0,Kirkland,98034,1190
4.0,2.0,1720,9600,1.0,0.0,0.0,3.0,1120,600,1961,2004,328211.9048,Snoqualmie,98065,1720
4.0,2.0,2380,17199,2.0,0.0,0.0,3.0,1530,850,1979,2014,470000.0,Renton,98059,2380
5.0,4.0,3690,11928,2.0,0.0,0.0,3.0,2540,1150,2006,0,437500.0,Seattle,98178,3690
3.0,2.0,1180,14292,1.0,0.0,0.0,3.0,1180,0,1981,2013,455000.0,FederalWay,98023,1180
4.0,3.0,3330,4000,1.0,0.0,0.0,3.0,1790,1540,1958,2004,850000.0,Bothell,98011,3330
3.0,2.0,1770,1235,3.0,0.0,0.0,3.0,1600,170,2007,0,436110.0,Redmond,98052,1770
3.0,2.0,2610,7510,2.0,0.0,0.0,3.0,2610,0,1996,0,725000.0,MapleValley,98038,2610
3.0,2.0,2050,9580,1.0,0.0,0.0,3.0,1400,650,1984,0,540000.0,Seattle,98102,2050
4.0,2.0,2050,7100,1.0,0.0,0.0,3.0,1050,1000,1963,2008,265000.0,Kirkland,98033,2050
4.0,2.0,2290,6738,2.0,0.0,0.0,3.0,2290,0,1996,0,570000.0,Issaquah,98027,2290
4.0,2.0,1120,8250,1.0,0.0,0.0,4.0,1120,0,1966,0,252000.0,MapleValley,98038,1120
2.0,2.0,1620,3196,2.0,0.0,0.0,3.0,1620,0,2008,0,386000.0,FederalWay,98003,1620
3.0,2.0,1700,3575,2.0,0.0,0.0,3.0,1700,0,2000,0,300000.0,Seattle,98118,1700
3.0,2.0,1413,3600,2.0,0.0,0.0,3.0,1413,0,2011,0,286800.0,Burien,98166,1413
4.0,1.0,1530,7200,1.5,0.0,0.0,3.0,1400,130,1948,1994,135333.3333,FederalWay,98023,1530
3.0,2.0,1930,1348,2.0,0.0,0.0,3.0,1300,630,2005,0,439990.0,Woodinville,98072,1930
4.0,3.0,4260,18000,2.0,0.0,2.0,3.0,4260,0,2000,0,435000.0,Redmond,98053,4260
3.0,1.0,1390,4814,1.5,0.0,0.0,3.0,1390,0,1908,1988,341000.0,Seattle,98106,1390
4.0,2.0,3560,12047,2.0,0.0,0.0,3.0,3560,0,1988,2000,486000.0,FederalWay,98023,3560
3.0,2.0,1620,7686,2.0,0.0,0.0,3.0,1620,0,1989,0,246500.0,Renton,98058,1620
2.0,1.0,800,6500,1.0,0.0,0.0,4.0,800,0,1953,1983,295000.0,Seattle,98125,800
4.0,2.0,1150,9360,1.5,0.0,0.0,3.0,1150,0,1970,2014,334000.0,Seattle,98178,1150
3.0,2.0,2180,7508,1.0,0.0,0.0,4.0,1420,760,1962,0,400000.0,Renton,98059,2180
5.0,3.0,2520,16100,1.0,0.0,3.0,4.0,1570,950,1960,2001,542500.0,Bellevue,98008,2520
3.0,2.0,2090,15000,1.0,0.0,0.0,3.0,2090,0,1961,2004,383000.0,FederalWay,98023,2090
4.0,3.0,2630,7505,2.0,0.0,0.0,3.0,2630,0,1994,0,725000.0,Duvall,98019,2630
3.0,3.0,1300,14197,1.0,0.0,0.0,3.0,860,440,1996,0,245000.0,YarrowPoint,98004,1300
2.0,1.0,1270,5000,1.0,0.0,0.0,3.0,1090,180,1949,1998,615000.0,Renton,98058,1270
3.0,1.0,1160,3750,1.5,0.0,0.0,3.0,1160,0,1910,2006,390000.0,FederalWay,98003,1160
2.0,1.0,1310,7128,1.0,0.0,0.0,4.0,940,370,1980,0,253000.0,Skykomish,98288,1310
3.0,2.0,1730,11325,1.0,0.0,0.0,5.0,1730,0,1972,0,228944.4444,FederalWay,98003,1730
3.0,2.0,1410,5760,1.0,0.0,0.0,3.0,1410,0,1985,0,245000.0,Kent,98030,1410
4.0,2.0,3000,9793,2.0,0.0,0.0,3.0,3000,0,2002,0,394000.0,Bellevue,98008,3000
4.0,2.0,2020,4350,2.0,0.0,0.0,5.0,1730,290,1943,0,554729.0,Covington,98042,2020
3.0,2.0,1900,7984,2.0,0.0,0.0,3.0,1900,0,1993,0,435000.0,Bellevue,98006,1900
4.0,2.0,2200,8065,2.0,0.0,0.0,3.0,2200,0,1998,2006,300000.0,Tukwila,98168,2200
3.0,2.0,1770,7000,1.0,0.0,0.0,3.0,1770,0,1986,0,241000.0,Renton,98059,1770
5.0,2.0,2290,7420,1.0,0.0,0.0,3.0,1290,1000,1973,2013,359900.0,Shoreline,98133,2290
5.0,3.0,3320,11340,2.0,0.0,0.0,4.0,2480,840,1999,0,409124.0,Auburn,98001,3320
3.0,2.0,1220,6000,1.0,0.0,0.0,3.0,1220,0,1968,1997,177500.0,Seattle,98177,1220
3.0,2.0,1530,8925,1.0,0.0,0.0,3.0,1530,0,1977,2004,371025.0,Auburn,98092,1530
4.0,2.0,1980,6660,2.0,0.0,0.0,4.0,1980,0,1974,0,463000.0,Seattle,98126,1980
5.0,2.0,3000,13899,2.0,0.0,0.0,4.0,3000,0,1975,0,600000.0,Bellevue,98006,3000
3.0,1.0,1440,11250,1.0,0.0,0.0,3.0,1440,0,1967,2011,290000.0,Renton,98059,1440
3.0,2.0,1820,8008,1.0,0.0,0.0,3.0,1240,580,1981,2013,475000.0,Newcastle,98059,1820
5.0,3.0,3350,4000,2.0,0.0,0.0,4.0,2510,840,1997,0,1110000.0,Renton,98058,3350
3.0,2.0,1760,6875,1.0,0.0,0.0,4.0,1760,0,1967,0,400000.0,Kenmore,98028,1760
3.0,3.0,2600,5875,1.5,0.0,2.0,5.0,1600,1000,1929,0,805000.0,Seattle,98178,2600
4.0,2.0,2690,18653,2.0,0.0,0.0,3.0,2690,0,1985,0,645000.0,Seattle,98112,2690
3.0,2.0,1170,8239,1.0,0.0,0.0,3.0,1170,0,1981,2013,205000.0,Bellevue,98004,1170
3.0,2.0,2300,9521,2.0,0.0,0.0,3.0,2300,0,2003,0,435000.0,Seattle,98133,2300
3.0,1.0,1130,12519,1.0,0.0,0.0,3.0,1130,0,1958,2004,243069.2308,Woodinville,98077,1130
3.0,2.0,1840,8086,1.0,0.0,0.0,4.0,1840,0,1964,0,550000.0,Issaquah,98027,1840
3.0,2.0,2180,7700,1.0,0.0,0.0,3.0,1480,700,1961,2004,506000.0,Seattle,98115,2180
3.0,2.0,2030,17100,1.0,0.0,0.0,4.0,2030,0,1953,1983,440000.0,Seattle,98105,2030
2.0,2.0,1240,3000,1.5,0.0,0.0,3.0,1240,0,1906,2014,362750.0,Issaquah,98027,1240
2.0,2.0,1600,4000,1.0,0.0,0.0,5.0,850,750,1918,0,690000.0,Kent,98031,1600
3.0,2.0,1110,9012,1.0,0.0,0.0,4.0,1110,0,1966,0,452000.0,Sammamish,98074,1110
2.0,2.0,1760,4400,1.0,0.0,0.0,4.0,880,880,1930,0,640000.0,Seattle,98116,1760
3.0,2.0,1680,9090,1.0,0.0,0.0,4.0,1130,550,1959,0,480000.0,MercerIsland,98040,1680
4.0,2.0,2300,7989,2.0,0.0,0.0,3.0,2300,0,1990,2009,560000.0,Issaquah,98029,2300
4.0,2.0,1550,9176,1.0,0.0,0.0,3.0,1000,550,1956,2001,418000.0,Seattle,98116,1550
4.0,2.0,1930,7207,1.0,0.0,0.0,4.0,1360,570,1988,0,280000.0,Seattle,98117,1930
3.0,1.0,930,5160,1.5,0.0,0.0,5.0,930,0,1919,1934,300000.0,Seattle,98103,930
2.0,2.0,1210,7507,1.0,0.0,0.0,3.0,1210,0,1982,0,342500.0,MercerIsland,98040,1210
3.0,1.0,1060,9946,1.0,0.0,0.0,4.0,1060,0,1956,0,230000.0,Carnation,98014,1060
4.0,2.0,2110,3750,2.0,0.0,0.0,3.0,2110,0,2000,0,577437.5,Seattle,98199,2110
4.0,2.0,2250,3916,2.0,0.0,0.0,3.0,2250,0,2014,0,333490.0,Redmond,98052,2250
4.0,2.0,1580,9581,1.0,0.0,0.0,3.0,1580,0,1953,0,410000.0,NormandyPark,98166,1580
3.0,2.0,1590,8911,1.0,0.0,0.0,3.0,1590,0,1956,2001,300000.0,Issaquah,98029,1590
4.0,3.0,2360,6250,1.0,0.0,2.0,3.0,1460,900,1960,2012,418000.0,Bothell,98011,2360
3.0,2.0,1750,11461,2.0,0.0,0.0,4.0,1750,0,1976,1992,232603.0,Renton,98058,1750
3.0,2.0,2200,5000,1.5,0.0,0.0,3.0,2200,0,1932,0,193000.0,Seattle,98118,2200
4.0,2.0,4570,16015,2.0,0.0,2.0,3.0,4570,0,1990,2009,1060000.0,Renton,98059,4570
3.0,2.0,2440,4153,2.0,0.0,0.0,3.0,2440,0,2003,0,710000.0,FederalWay,98001,2440
2.0,2.0,1610,17600,2.0,0.0,0.0,3.0,1610,0,1930,1983,290900.0,MapleValley,98038,1610
3.0,2.0,1380,7476,1.0,0.0,0.0,3.0,1380,0,1989,0,272000.0,Seattle,98136,1380
3.0,2.0,2020,8555,1.0,0.0,0.0,4.0,1220,800,1957,2001,300000.0,Seattle,98118,2020
2.0,1.0,2034,13392,1.0,1.0,4.0,5.0,1159,875,1947,0,549000.0,Seattle,98199,2034
4.0,2.0,3640,10576,2.0,0.0,0.0,3.0,3640,0,1999,0,913000.0,Seattle,98125,3640
4.0,2.0,2300,7700,1.0,0.0,0.0,3.0,1380,920,1959,1989,417000.0,Bellevue,98006,2300
3.0,2.0,1900,3960,1.5,0.0,0.0,3.0,1200,700,1905,2010,580000.0,Enumclaw,98022,1900
4.0,2.0,2080,13510,1.0,0.0,0.0,3.0,1040,1040,1950,2005,248000.0,Issaquah,98029,2080
3.0,2.0,1270,8100,1.0,0.0,0.0,3.0,880,390,1950,2005,346000.0,Auburn,98092,1270
4.0,3.0,3450,6184,2.0,0.0,0.0,3.0,3450,0,2014,0,852880.0,Kent,98032,3450
3.0,2.0,1860,11227,2.0,0.0,0.0,3.0,1860,0,1995,0,330000.0,Redmond,98053,1860
4.0,2.0,1880,3840,1.0,0.0,0.0,3.0,970,910,1904,0,435000.0,Seattle,98178,1880
3.0,2.0,1390,1484,3.0,0.0,0.0,3.0,1390,0,2007,0,374950.0,Seattle,98108,1390
3.0,2.0,1140,8340,1.0,0.0,0.0,3.0,1140,0,1960,2012,200000.0,Seattle,98118,1140
4.0,2.0,1530,8750,1.5,0.0,0.0,4.0,1530,0,1968,0,269900.0,Seattle,98103,1530
2.0,1.0,1200,4880,1.0,0.0,0.0,3.0,980,220,1943,2002,245000.0,Burien,98166,1200
4.0,2.0,2970,4400,2.0,0.0,0.0,3.0,2970,0,2014,0,775950.0,Bellevue,98007,2970
4.0,2.0,2370,10083,2.0,0.0,0.0,5.0,2370,0,1966,0,687000.0,FederalWay,98023,2370
2.0,2.0,1410,1005,1.5,0.0,0.0,3.0,900,510,2011,0,399900.0,Seattle,98108,1410
5.0,2.0,2160,7737,2.0,0.0,0.0,3.0,2160,0,1998,2006,480000.0,Snoqualmie,98065,2160
3.0,1.0,960,9563,1.0,0.0,0.0,5.0,960,0,1967,0,215000.0,Seattle,98112,960
2.0,2.0,2550,6000,2.0,0.0,0.0,5.0,1860,690,1902,0,660000.0,Renton,98055,2550
4.0,2.0,1980,10800,1.0,0.0,0.0,5.0,990,990,1948,1985,711000.0,Seattle,98177,1980
3.0,1.0,1400,8100,1.5,0.0,0.0,3.0,1400,0,1944,0,267000.0,Issaquah,98029,1400
3.0,2.0,1320,1800,2.0,0.0,0.0,3.0,1320,0,1994,0,540000.0,Seattle,98116,1320
3.0,1.0,1150,5100,2.0,0.0,0.0,3.0,1150,0,1911,2005,500000.0,Woodinville,98077,1150
4.0,2.0,2030,18295,1.5,0.0,0.0,4.0,2030,0,1975,0,493000.0,Seattle,98146,2030
4.0,2.0,2180,3375,1.5,0.0,0.0,4.0,1420,760,1926,1993,657000.0,Issaquah,98029,2180
3.0,2.0,2330,11740,1.0,0.0,0.0,3.0,1330,1000,1954,2005,450000.0,Redmond,98052,2330
3.0,2.0,1580,8820,1.0,0.0,0.0,4.0,1580,0,1967,0,225000.0,Seattle,98144,1580
4.0,2.0,3220,7875,1.5,0.0,0.0,4.0,3220,0,1966,0,590000.0,Sammamish,98074,3220
2.0,2.0,1350,4614,1.0,0.0,0.0,3.0,1350,0,2008,0,498800.0,Issaquah,98029,1350
4.0,1.0,1600,10183,1.0,0.0,0.0,4.0,1600,0,1966,0,154950.0,Seattle,98103,1600
4.0,2.0,1720,8300,1.0,0.0,0.0,4.0,1720,0,1973,0,240015.3333,Redmond,98052,1720
3.0,2.0,1330,13102,1.0,0.0,0.0,3.0,1330,0,1968,1997,225000.0,MercerIsland,98040,1330
2.0,1.0,750,5120,1.0,0.0,0.0,4.0,750,0,1941,1998,300000.0,Seattle,98144,750
2.0,1.0,720,4222,1.0,0.0,0.0,4.0,720,0,1942,1982,127160.0,Seattle,98122,720
2.0,2.0,1540,965,3.0,0.0,0.0,3.0,1540,0,2007,0,640000.0,LakeForestPark,98155,1540
3.0,2.0,1150,8079,1.0,0.0,0.0,4.0,1150,0,1983,0,220083.3333,Burien,98166,1150
4.0,2.0,3550,13900,1.0,0.0,0.0,3.0,1830,1720,2010,0,859000.0,Seattle,98115,3550
4.0,2.0,1760,6204,1.0,0.0,2.0,4.0,1180,580,1950,1983,343500.0,Vashon,98070,1760
2.0,2.0,1820,8867,2.0,0.0,0.0,3.0,1820,0,1921,2000,206000.0,Seattle,98117,1820
2.0,2.0,830,1858,2.0,0.0,0.0,3.0,830,0,2005,0,334500.0,Kirkland,98034,830
3.0,2.0,1190,6833,1.0,0.0,0.0,3.0,1190,0,1995,0,200000.0,Seattle,98126,1190
3.0,2.0,1860,4777,2.0,0.0,0.0,5.0,1860,0,1908,0,588000.0,Seattle,98199,1860
3.0,2.0,1380,8682,1.0,0.0,0.0,4.0,1380,0,1966,0,295000.0,Renton,98059,1380
4.0,2.0,3670,7680,2.5,0.0,0.0,3.0,3670,0,2007,0,950000.0,Kent,98042,3670
5.0,3.0,2795,15101,2.0,0.0,0.0,3.0,2795,0,1996,0,562000.0,Seattle,98136,2795
3.0,2.0,1870,9000,1.0,0.0,0.0,5.0,1870,0,1958,0,595888.0,Seattle,98106,1870
3.0,2.0,1550,6039,1.0,0.0,0.0,5.0,830,720,1942,0,430000.0,FederalWay,98023,1550
4.0,3.0,2530,7350,1.0,0.0,0.0,5.0,1280,1250,1977,0,354950.0,MapleValley,98038,2530
3.0,2.0,2150,8221,2.0,0.0,0.0,3.0,2150,0,1992,0,470000.0,Seattle,98103,2150
3.0,2.0,1330,8100,1.0,0.0,0.0,4.0,1330,0,1969,0,420642.8571,Carnation,98014,1330
3.0,2.0,1610,4611,2.0,0.0,0.0,3.0,1610,0,1996,0,505000.0,Seattle,98122,1610
4.0,1.0,1390,18000,1.0,0.0,0.0,3.0,1390,0,1955,2013,234000.0,Carnation,98014,1390
3.0,2.0,2600,5100,2.0,0.0,1.0,3.0,2600,0,1998,2006,583000.0,Auburn,98001,2600
4.0,2.0,2200,7700,1.0,0.0,0.0,3.0,1100,1100,1979,2014,279000.0,Kenmore,98028,2200
2.0,1.0,760,5500,1.5,0.0,0.0,3.0,760,0,1947,2012,163785.7143,Sammamish,98074,760
3.0,2.0,1970,9607,2.0,0.0,0.0,3.0,1090,880,1988,2000,289000.0,Seattle,98117,1970
3.0,1.0,1200,13100,1.0,0.0,0.0,3.0,1200,0,1943,2002,165000.0,ClydeHill,98004,1200
4.0,2.0,1850,5040,1.0,0.0,0.0,3.0,1230,620,1930,2013,449000.0,FederalWay,98023,1850
4.0,2.0,2300,6158,2.0,0.0,0.0,3.0,2300,0,1999,0,775000.0,Shoreline,98177,2300
2.0,2.0,2360,11340,1.5,0.0,0.0,3.0,2360,0,1997,0,1087500.0,Bellevue,98004,2360
4.0,2.0,1550,3000,1.5,0.0,0.0,3.0,1350,200,1918,0,458000.0,Bellevue,98004,1550
2.0,1.0,970,5500,1.0,0.0,0.0,3.0,970,0,1956,2001,210000.0,Redmond,98053,970
4.0,2.0,3170,8523,2.0,0.0,0.0,3.0,3170,0,2008,0,820000.0,DesMoines,98148,3170
3.0,2.0,1220,1330,2.0,0.0,0.0,3.0,1010,210,2008,0,457000.0,Seattle,98117,1220
3.0,2.0,1280,10716,1.0,0.0,0.0,4.0,1280,0,1969,0,317061.875,Issaquah,98029,1280
4.0,1.0,1200,2171,1.5,0.0,0.0,3.0,1200,0,1933,0,240000.0,Seattle,98199,1200
3.0,2.0,1530,6743,1.0,0.0,0.0,3.0,1410,120,1955,2005,575000.0,Seattle,98106,1530
3.0,3.0,2590,12063,2.0,0.0,0.0,3.0,2590,0,1993,0,695000.0,Sammamish,98075,2590
3.0,3.0,1830,1850,2.0,0.0,0.0,3.0,1690,140,2011,0,593000.0,Seattle,98125,1830
2.0,1.0,720,8040,1.0,0.0,0.0,3.0,720,0,1943,2002,210000.0,Renton,98058,720
3.0,4.0,1950,8625,1.0,0.0,0.0,3.0,1360,590,1959,1989,345100.0,Seattle,98108,1950
4.0,1.0,1980,10350,1.0,0.0,0.0,4.0,1430,550,1968,0,395000.0,Bellevue,98004,1980
3.0,2.0,2340,3477,1.0,0.0,1.0,5.0,1170,1170,1971,0,560000.0,Seattle,98119,2340
4.0,1.0,1600,5500,1.5,0.0,0.0,4.0,1600,0,1946,1989,625000.0,Kirkland,98033,1600
4.0,3.0,3070,7201,2.0,0.0,0.0,3.0,3070,0,2006,0,535000.0,Seattle,98126,3070
4.0,1.0,2080,5500,1.0,0.0,0.0,3.0,1040,1040,1941,1994,480000.0,Seattle,98115,2080
3.0,2.0,1790,8144,2.0,0.0,0.0,3.0,1790,0,1989,0,583000.0,Sammamish,98075,1790
